"PIH	1347 Property Insurance Holdings, Inc.	NASDAQ",
"FLWS	1-800 FLOWERS.COM, Inc.	NASDAQ",
"FCTY	1st Century Bancshares, Inc	NASDAQ",
"FCCY	1st Constitution Bancorp (NJ)	NASDAQ",
"SRCE	1st Source Corporation	NASDAQ",
"FUBC	1st United Bancorp, Inc. (FL)	NASDAQ",
"VNET	21Vianet Group, Inc.	NASDAQ",
"TWOU	2U, Inc.	NASDAQ",
"JOBS	51job, Inc.	NASDAQ",
"EGHT	8x8 Inc	NASDAQ",
"AVHI	A V Homes, Inc.	NASDAQ",
"SHLM	A. Schulman, Inc.	NASDAQ",
"AAON	AAON, Inc.	NASDAQ",
"ASTM	Aastrom Biosciences, Inc.	NASDAQ",
"ABAX	ABAXIS, Inc.	NASDAQ",
"ABGB	Abengoa, S.A.	NASDAQ",
"ABMD	ABIOMED, Inc.	NASDAQ",
"AXAS	Abraxas Petroleum Corporation	NASDAQ",
"ACTG	Acacia Research Corporation	NASDAQ",
"ACHC	Acadia Healthcare Company, Inc.	NASDAQ",
"ACAD	ACADIA Pharmaceuticals Inc.	NASDAQ",
"ACST	Acasti Pharma, Inc.	NASDAQ",
"AXDX	Accelerate Diagnostics, Inc.	NASDAQ",
"XLRN	Acceleron Pharma Inc.	NASDAQ",
"ACCL	Accelrys, Inc.	NASDAQ",
"ANCX	Access National Corporation	NASDAQ",
"ARAY	Accuray Incorporated	NASDAQ",
"ACRX	AcelRx Pharmaceuticals, Inc.	NASDAQ",
"ACET	Aceto Corporation	NASDAQ",
"AKAO	Achaogen, Inc.	NASDAQ",
"ACHN	Achillion Pharmaceuticals, Inc.	NASDAQ",
"ACIW	ACI Worldwide, Inc.	NASDAQ",
"ACNB	ACNB Corporation	NASDAQ",
"ACOR	Acorda Therapeutics, Inc.	NASDAQ",
"ACFN	Acorn Energy, Inc.	NASDAQ",
"ACTS	Actions Semiconductor Co., Ltd.	NASDAQ",
"ACPW	Active Power, Inc.	NASDAQ",
"ATVI	Activision Blizzard, Inc	NASDAQ",
"BIRT	Actuate Corporation	NASDAQ",
"ACUR	Acura Pharmaceuticals, Inc.	NASDAQ",
"ACXM	Acxiom Corporation	NASDAQ",
"ADMP	Adamis Pharmaceuticals Corporation	NASDAQ",
"ADUS	Addus HomeCare Corporation	NASDAQ",
"AEY	ADDvantage Technologies Group, Inc.	NASDAQ",
"ADEP	Adept Technology, Inc.	NASDAQ",
"ADBE	Adobe Systems Incorporated	NASDAQ",
"ADTN	ADTRAN, Inc.	NASDAQ",
"ADES	Advanced Emissions Solutions, Inc.	NASDAQ",
"AEIS	Advanced Energy Industries, Inc.	NASDAQ",
"ADXS	Advaxis, Inc.	NASDAQ",
"ADXSW	Advaxis, Inc.	NASDAQ",
"ADVS	Advent Software, Inc.	NASDAQ",
"YPRO	AdvisorShares YieldPro ETF	NASDAQ",
"AEGR	Aegerion Pharmaceuticals, Inc.	NASDAQ",
"AEGN	Aegion Corp	NASDAQ",
"AEHR	Aehr Test Systems	NASDAQ",
"AEPI	AEP Industries Inc.	NASDAQ",
"AERI	Aerie Pharmaceuticals, Inc.	NASDAQ",
"AVAV	AeroVironment, Inc.	NASDAQ",
"AEZS	AEterna Zentaris Inc.	NASDAQ",
"ATRM	Aetrium Incorporated	NASDAQ",
"AFFX	Affymetrix, Inc.	NASDAQ",
"AGEN	Agenus Inc.	NASDAQ",
"AGYS	Agilysys, Inc.	NASDAQ",
"AGIO	Agios Pharmaceuticals, Inc.	NASDAQ",
"AIRM	Air Methods Corporation	NASDAQ",
"AIRT	Air T, Inc.	NASDAQ",
"ATSG	Air Transport Services Group, Inc	NASDAQ",
"AMCN	AirMedia Group Inc	NASDAQ",
"AIXG	Aixtron SE	NASDAQ",
"AKAM	Akamai Technologies, Inc.	NASDAQ",
"AKBA	Akebia Therapeutics, Inc.	NASDAQ",
"AKER	Akers Biosciences Inc	NASDAQ",
"AKRX	Akorn, Inc.	NASDAQ",
"ALSK	Alaska Communications Systems Group, Inc.	NASDAQ",
"AMRI	Albany Molecular Research, Inc.	NASDAQ",
"ALCS	ALCO Stores, Inc.	NASDAQ",
"ADHD	Alcobra Ltd.	NASDAQ",
"ALXN	Alexion Pharmaceuticals, Inc.	NASDAQ",
"ALXA	Alexza Pharmaceuticals, Inc.	NASDAQ",
"ALCO	Alico, Inc.	NASDAQ",
"ALGN	Align Technology, Inc.	NASDAQ",
"ALIM	Alimera Sciences, Inc.	NASDAQ",
"ALKS	Alkermes plc	NASDAQ",
"ALGT	Allegiant Travel Company	NASDAQ",
"ALLB	Alliance Bancorp, Inc. of Pennsylvania	NASDAQ",
"AFOP	Alliance Fiber Optic Products, Inc.	NASDAQ",
"AIQ	Alliance HealthCare Services, Inc.	NASDAQ",
"AHGP	Alliance Holdings GP, L.P.	NASDAQ",
"ARLP	Alliance Resource Partners, L.P.	NASDAQ",
"AHPI	Allied Healthcare Products, Inc.	NASDAQ",
"AMOT	Allied Motion Technologies, Inc.	NASDAQ",
"ALQA	Alliqua, Inc.	NASDAQ",
"ALLT	Allot Communications Ltd.	NASDAQ",
"MDRX	Allscripts Healthcare Solutions, Inc.	NASDAQ",
"AFAM	Almost Family Inc	NASDAQ",
"ALNY	Alnylam Pharmaceuticals, Inc.	NASDAQ",
"AOSL	Alpha and Omega Semiconductor Limited	NASDAQ",
"ATEC	Alphatec Holdings, Inc.	NASDAQ",
"ALTI	Altair Nanotechnologies Inc.	NASDAQ",
"ALTR	Altera Corporation	NASDAQ",
"ASPS	Altisource Portfolio Solutions S.A.	NASDAQ",
"APSA	Alto Palermo S.A.	NASDAQ",
"AIMC	Altra Industrial Motion Corp.	NASDAQ",
"AMAG	AMAG Pharmaceuticals, Inc.	NASDAQ",
"AMRN	Amarin Corporation PLC	NASDAQ",
"AMRK	A-Mark Precious Metals, Inc.	NASDAQ",
"AMZN	Amazon.com, Inc.	NASDAQ",
"AMBC	Ambac Financial Group, Inc.	NASDAQ",
"AMBCW	Ambac Financial Group, Inc.	NASDAQ",
"AMBA	Ambarella, Inc.	NASDAQ",
"EPAX	Ambassadors Group, Inc.	NASDAQ",
"AMBT	Ambient Corporation	NASDAQ",
"AMBI	Ambit Biosciences Corporation	NASDAQ",
"AMCX	AMC Networks Inc.	NASDAQ",
"DOX	Amdocs Limited	NASDAQ",
"AMDA	Amedica Corporation	NASDAQ",
"AMED	Amedisys Inc	NASDAQ",
"UHAL	Amerco	NASDAQ",
"ASBI	Ameriana Bancorp	NASDAQ",
"ATAX	America First Multifamily Investors, L.P.	NASDAQ",
"AMOV	America Movil, S.A.B. de C.V.	NASDAQ",
"AAL	American Airlines Group, Inc.	NASDAQ",
"AALCP	American Airlines Group, Inc.	NASDAQ",
"AGNC	American Capital Agency Corp.	NASDAQ",
"AGNCP	American Capital Agency Corp.	NASDAQ",
"MTGE	American Capital Mortgage Investment Corp.	NASDAQ",
"ACSF	American Capital Senior Floating, Ltd.	NASDAQ",
"ACAS	American Capital, Ltd.	NASDAQ",
"ANCI	American Caresource Holdings Inc	NASDAQ",
"AETI	American Electric Technologies, Inc.	NASDAQ",
"AMIC	American Independence Corp.	NASDAQ",
"AMNB	American National Bankshares, Inc.	NASDAQ",
"ANAT	American National Insurance Company	NASDAQ",
"APEI	American Public Education, Inc.	NASDAQ",
"ARII	American Railcar Industries, Inc.	NASDAQ",
"ARCP	American Realty Capital Properties, Inc.	NASDAQ",
"ARCPP	American Realty Capital Properties, Inc.	NASDAQ",
"AMRB	American River Bankshares	NASDAQ",
"ASEI	American Science and Engineering, Inc.	NASDAQ",
"AMSWA	American Software, Inc.	NASDAQ",
"AMSC	American Superconductor Corporation	NASDAQ",
"AMWD	American Woodmark Corporation	NASDAQ",
"CRMT	America&#39;s Car-Mart, Inc.	NASDAQ",
"ABCB	Ameris Bancorp	NASDAQ",
"AMSF	AMERISAFE, Inc.	NASDAQ",
"ASRV	AmeriServ Financial Inc.	NASDAQ",
"ASRVP	AmeriServ Financial Inc.	NASDAQ",
"ATLO	Ames National Corporation	NASDAQ",
"AMGN	Amgen Inc.	NASDAQ",
"FOLD	Amicus Therapeutics, Inc.	NASDAQ",
"AMKR	Amkor Technology, Inc.	NASDAQ",
"AMSG	Amsurg Corp.	NASDAQ",
"ASYS	Amtech Systems, Inc.	NASDAQ",
"AFSI	AmTrust Financial Services, Inc.	NASDAQ",
"AMRS	Amyris, Inc.	NASDAQ",
"ANAC	Anacor Pharmaceuticals, Inc.	NASDAQ",
"ANAD	ANADIGICS, Inc.	NASDAQ",
"ADI	Analog Devices, Inc.	NASDAQ",
"ALOG	Analogic Corporation	NASDAQ",
"ANCB	Anchor Bancorp	NASDAQ",
"AMCF	Andatee China Marine Fuel Services Corporation	NASDAQ",
"ANGI	Angie&#39;s List, Inc.	NASDAQ",
"ANGO	AngioDynamics, Inc.	NASDAQ",
"ANIP	ANI Pharmaceuticals, Inc.	NASDAQ",
"ANIK	Anika Therapeutics Inc.	NASDAQ",
"ANSS	ANSYS, Inc.	NASDAQ",
"ATRS	Antares Pharma, Inc.	NASDAQ",
"ANTH	Anthera Pharmaceuticals, Inc.	NASDAQ",
"APAGF	Apco Oil and Gas International Inc.	NASDAQ",
"ATNY	API Technologies Corp.	NASDAQ",
"APOG	Apogee Enterprises, Inc.	NASDAQ",
"APOL	Apollo Education Group, Inc.	NASDAQ",
"AINV	Apollo Investment Corporation	NASDAQ",
"AAPL	Apple Inc.	NASDAQ",
"ARCI	Appliance Recycling Centers of America, Inc.	NASDAQ",
"AGTC	Applied Genetic Technologies Corporation	NASDAQ",
"AMAT	Applied Materials, Inc.	NASDAQ",
"AMCC	Applied Micro Circuits Corporation	NASDAQ",
"AAOI	Applied Optoelectronics, Inc.	NASDAQ",
"AREX	Approach Resources Inc.	NASDAQ",
"APRI	Apricus Biosciences, Inc	NASDAQ",
"AQU	Aquasition Corp.	NASDAQ",
"AQUUU	Aquasition Corp.	NASDAQ",
"AQUUW	Aquasition Corp.	NASDAQ",
"AQXP	Aquinox Pharmaceuticals, Inc.	NASDAQ",
"PETX	Aratana Therapeutics, Inc.	NASDAQ",
"ARCW	ARC Group Worldwide, Inc.	NASDAQ",
"ABIO	ARCA biopharma, Inc.	NASDAQ",
"ACGL	Arch Capital Group Ltd.	NASDAQ",
"ACAT	Arctic Cat Inc.	NASDAQ",
"ARNA	Arena Pharmaceuticals, Inc.	NASDAQ",
"ARCC	Ares Capital Corporation	NASDAQ",
"AGII	Argo Group International Holdings, Ltd.	NASDAQ",
"AGIIL	Argo Group International Holdings, Ltd.	NASDAQ",
"ARGS	Argos Therapeutics, Inc.	NASDAQ",
"ARIS	ARI Network Services, Inc.	NASDAQ",
"ARIA	ARIAD Pharmaceuticals, Inc.	NASDAQ",
"ARKR	Ark Restaurants Corp.	NASDAQ",
"ABFS	Arkansas Best Corporation	NASDAQ",
"ARMH	ARM Holdings plc	NASDAQ",
"ARTX	Arotech Corporation	NASDAQ",
"ARQL	ArQule, Inc.	NASDAQ",
"ARRY	Array BioPharma Inc.	NASDAQ",
"ARRS	ARRIS Group, Inc.	NASDAQ",
"AROW	Arrow Financial Corporation	NASDAQ",
"ARWR	Arrowhead Research Corporation	NASDAQ",
"ARTNA	Artesian Resources Corporation	NASDAQ",
"ARTC	ArthroCare Corporation	NASDAQ",
"ARTW	Art&#39;s-Way Manufacturing Co., Inc.	NASDAQ",
"ARUN	Aruba Networks, Inc.	NASDAQ",
"ASBB	ASB Bancorp, Inc.	NASDAQ",
"ASNA	Ascena Retail Group, Inc.	NASDAQ",
"ASCMA	Ascent Capital Group, Inc.	NASDAQ",
"ASTI	Ascent Solar Technologies, Inc.	NASDAQ",
"APWC	Asia Pacific Wire & Cable Corporation Limited	NASDAQ",
"ASMI	ASM International N.V.	NASDAQ",
"ASML	ASML Holding N.V.	NASDAQ",
"AZPN	Aspen Technology, Inc.	NASDAQ",
"ASBC	Associated Banc-Corp	NASDAQ",
"ASBCW	Associated Banc-Corp	NASDAQ",
"ASFI	Asta Funding, Inc.	NASDAQ",
"ATEA	Astea International, Inc.	NASDAQ",
"ASTE	Astec Industries, Inc.	NASDAQ",
"ALOT	Astro-Med, Inc.	NASDAQ",
"ATRO	Astronics Corporation	NASDAQ",
"ASTC	Astrotech Corporation	NASDAQ",
"ASUR	Asure Software Inc	NASDAQ",
"ATAI	ATA Inc.	NASDAQ",
"ATHN	athenahealth, Inc.	NASDAQ",
"AFCB	Athens Bancshares Corporation	NASDAQ",
"ATHX	Athersys, Inc.	NASDAQ",
"AAME	Atlantic American Corporation	NASDAQ",
"ACFC	Atlantic Coast Financial Corporation	NASDAQ",
"ATNI	Atlantic Tele-Network, Inc.	NASDAQ",
"ATLC	Atlanticus Holdings Corporation	NASDAQ",
"AAWW	Atlas Air Worldwide Holdings	NASDAQ",
"AFH	Atlas Financial Holdings, Inc.	NASDAQ",
"ATML	Atmel Corporation	NASDAQ",
"ATMI	ATMI Inc.	NASDAQ",
"ATOS	Atossa Genetics Inc.	NASDAQ",
"ATRC	AtriCure, Inc.	NASDAQ",
"ATRI	ATRION Corporation	NASDAQ",
"ATTU	Attunity Ltd.	NASDAQ",
"AUBN	Auburn National Bancorporation, Inc.	NASDAQ",
"ADNC	Audience, Inc.	NASDAQ",
"AUDC	AudioCodes Ltd.	NASDAQ",
"ASPX	Auspex Pharmaceuticals, Inc.	NASDAQ",
"ADAT	Authentidate Holding Corp.	NASDAQ",
"ABTL	Autobytel Inc.	NASDAQ",
"ADSK	Autodesk, Inc.	NASDAQ",
"ADP	Automatic Data Processing, Inc.	NASDAQ",
"AMAP	AutoNavi Holdings Limited	NASDAQ",
"AUXL	Auxilium Pharmaceuticals, Inc.	NASDAQ",
"AVGO	Avago Technologies Limited	NASDAQ",
"AVNR	Avanir Pharmaceuticals, Inc.	NASDAQ",
"AVEO	AVEO Pharmaceuticals, Inc.	NASDAQ",
"AVNW	Aviat Networks, Inc.	NASDAQ",
"CAR	Avis Budget Group, Inc.	NASDAQ",
"AWRE	Aware, Inc.	NASDAQ",
"ACLS	Axcelis Technologies, Inc.	NASDAQ",
"AXGN	AxoGen, Inc.	NASDAQ",
"AXTI	AXT Inc	NASDAQ",
"BCOM	B Communications Ltd.	NASDAQ",
"BOSC	B.O.S. Better Online Solutions	NASDAQ",
"BEAV	B/E Aerospace, Inc.	NASDAQ",
"BIDU	Baidu, Inc.	NASDAQ",
"BCPC	Balchem Corporation	NASDAQ",
"BWINA	Baldwin & Lyons, Inc.	NASDAQ",
"BWINB	Baldwin & Lyons, Inc.	NASDAQ",
"BLDP	Ballard Power Systems, Inc.	NASDAQ",
"BANC	Banc of California, Inc.	NASDAQ",
"BANCL	Banc of California, Inc.	NASDAQ",
"BANCP	Banc of California, Inc.	NASDAQ",
"BANF	BancFirst Corporation	NASDAQ",
"BANFP	BancFirst Corporation	NASDAQ",
"BKMU	Bank Mutual Corporation	NASDAQ",
"BOCH	Bank of Commerce Holdings (CA)	NASDAQ",
"BMRC	Bank of Marin Bancorp	NASDAQ",
"BKSC	Bank of South Carolina Corp.	NASDAQ",
"BOTJ	Bank of the James Financial Group, Inc.	NASDAQ",
"OZRK	Bank of the Ozarks	NASDAQ",
"BFIN	BankFinancial Corporation	NASDAQ",
"BANR	Banner Corporation	NASDAQ",
"BBSI	Barrett Business Services, Inc.	NASDAQ",
"BSET	Bassett Furniture Industries, Incorporated	NASDAQ",
"BAXS	Baxano Surgical, Inc.	NASDAQ",
"BYBK	Bay Bancorp, Inc.	NASDAQ",
"BYLK	Baylake Corp	NASDAQ",
"BV	Bazaarvoice, Inc.	NASDAQ",
"BBCN	BBCN Bancorp, Inc.	NASDAQ",
"BCBP	BCB Bancorp, Inc. (NJ)	NASDAQ",
"BECN	Beacon Roofing Supply, Inc.	NASDAQ",
"BBGI	Beasley Broadcast Group, Inc.	NASDAQ",
"BEBE	bebe stores, inc.	NASDAQ",
"BBBY	Bed Bath & Beyond Inc.	NASDAQ",
"BELFA	Bel Fuse Inc.	NASDAQ",
"BELFB	Bel Fuse Inc.	NASDAQ",
"BNCL	Beneficial Mutual Bancorp, Inc.	NASDAQ",
"BNFT	Benefitfocus, Inc.	NASDAQ",
"BGMD	BG Medicine, Inc.	NASDAQ",
"BGCP	BGC Partners, Inc.	NASDAQ",
"BGFV	Big 5 Sporting Goods Corporation	NASDAQ",
"BIND	BIND Therapeutics, Inc.	NASDAQ",
"BASI	Bioanalytical Systems, Inc.	NASDAQ",
"BIOC	Biocept, Inc.	NASDAQ",
"BCRX	BioCryst Pharmaceuticals, Inc.	NASDAQ",
"BIOD	Biodel Inc.	NASDAQ",
"BDSI	BioDelivery Sciences International, Inc.	NASDAQ",
"BIOF	BioFuel Energy Corp.	NASDAQ",
"BIIB	Biogen Idec Inc.	NASDAQ",
"BIOL	Biolase, Inc.	NASDAQ",
"BLFS	BioLife Solutions, Inc.	NASDAQ",
"BLRX	BioLineRx Ltd.	NASDAQ",
"BMRN	BioMarin Pharmaceutical Inc.	NASDAQ",
"BPTH	Bio-Path Holdings Inc	NASDAQ",
"BRLI	Bio-Reference Laboratories, Inc.	NASDAQ",
"BIOS	BioScrip, Inc.	NASDAQ",
"BSTC	BioSpecifics Technologies Corp	NASDAQ",
"BSPM	Biostar Pharmaceuticals, Inc.	NASDAQ",
"BOTA	Biota Pharmaceuticals, Inc.	NASDAQ",
"BEAT	BioTelemetry, Inc.	NASDAQ",
"BDMS	Birner Dental Management Services, Inc.	NASDAQ",
"BJRI	BJ&#39;s Restaurants, Inc.	NASDAQ",
"BBOX	Black Box Corporation	NASDAQ",
"BDE	Black Diamond, Inc.	NASDAQ",
"BLKB	Blackbaud, Inc.	NASDAQ",
"BBRY	BlackBerry Limited	NASDAQ",
"HAWK	Blackhawk Network Holdings, Inc.	NASDAQ",
"HAWKV	Blackhawk Network Holdings, Inc.	NASDAQ",
"BKCC	BlackRock Kelso Capital Corporation	NASDAQ",
"ADRA	BLDRS Asia 50 ADR Index Fund	NASDAQ",
"ADRD	BLDRS Developed Markets 100 ADR Index Fund	NASDAQ",
"ADRE	BLDRS Emerging Markets 50 ADR Index Fund	NASDAQ",
"ADRU	BLDRS Europe 100 ADR Index Fund	NASDAQ",
"BLMN	Bloomin&#39; Brands, Inc.	NASDAQ",
"BCOR	Blucora, Inc.	NASDAQ",
"NILE	Blue Nile, Inc.	NASDAQ",
"BLUE	bluebird bio, Inc.	NASDAQ",
"BKEP	Blueknight Energy Partners L.P., L.L.C.	NASDAQ",
"BKEPP	Blueknight Energy Partners L.P., L.L.C.	NASDAQ",
"BPHX	BluePhoenix Solutions, Ltd.	NASDAQ",
"BNCN	BNC Bancorp	NASDAQ",
"BOBE	Bob Evans Farms, Inc.	NASDAQ",
"BODY	Body Central Corp.	NASDAQ",
"BOFI	BofI Holding, Inc.	NASDAQ",
"WIFI	Boingo Wireless, Inc.	NASDAQ",
"BOKF	BOK Financial Corporation	NASDAQ",
"BOLT	Bolt Technology Corporation	NASDAQ",
"BONA	Bona Film Group Limited	NASDAQ",
"BNSO	Bonso Electronics International, Inc.	NASDAQ",
"BAMM	Books-A-Million, Inc.	NASDAQ",
"BRDR	Borderfree, Inc.	NASDAQ",
"BPFH	Boston Private Financial Holdings, Inc.	NASDAQ",
"BPFHP	Boston Private Financial Holdings, Inc.	NASDAQ",
"BPFHW	Boston Private Financial Holdings, Inc.	NASDAQ",
"EPAY	Bottomline Technologies, Inc.	NASDAQ",
"BDBD	Boulder Brands, Inc.	NASDAQ",
"BLVDU	Boulevard Acquisition Corp.	NASDAQ",
"BBRG	Bravo Brio Restaurant Group, Inc.	NASDAQ",
"BBEP	BreitBurn Energy Partners, L.P.	NASDAQ",
"BDGE	Bridge Bancorp, Inc.	NASDAQ",
"BBNK	Bridge Capital Holdings	NASDAQ",
"BLIN          	Bridgeline Digital, Inc.	NASDAQ",
"BRID	Bridgford Foods Corporation	NASDAQ",
"BCOV	Brightcove Inc.	NASDAQ",
"BRCM	Broadcom Corporation	NASDAQ",
"BSFT	BroadSoft, Inc.	NASDAQ",
"BVSN	BroadVision, Inc.	NASDAQ",
"BYFC	Broadway Financial Corporation	NASDAQ",
"BWEN	Broadwind Energy, Inc.	NASDAQ",
"BRCD	Brocade Communications Systems, Inc.	NASDAQ",
"BRKL	Brookline Bancorp, Inc.	NASDAQ",
"BRKS	Brooks Automation, Inc.	NASDAQ",
"BRKR	Bruker Corporation	NASDAQ",
"BMTC	Bryn Mawr Bank Corporation	NASDAQ",
"BLMT	BSB Bancorp, Inc.	NASDAQ",
"BSDM	BSD Medical Corporation	NASDAQ",
"BSQR	BSQUARE Corporation	NASDAQ",
"BTUI	BTU International, Inc.	NASDAQ",
"BWLD	Buffalo Wild Wings, Inc.	NASDAQ",
"BLDR	Builders FirstSource, Inc.	NASDAQ",
"BUR	Burcon Nutrascience Corp	NASDAQ",
"CFFI	C&F Financial Corporation	NASDAQ",
"CHRW	C.H. Robinson Worldwide, Inc.	NASDAQ",
"CA	CA Inc.	NASDAQ",
"CCMP	Cabot Microelectronics Corporation	NASDAQ",
"CACH	Cache, Inc.	NASDAQ",
"CDNS	Cadence Design Systems, Inc.	NASDAQ",
"CDZI	Cadiz, Inc.	NASDAQ",
"CACQ	Caesars Acquisition Company	NASDAQ",
"CZR	Caesars Entertainment Corporation	NASDAQ",
"CSTE	CaesarStone Sdot-Yam Ltd.	NASDAQ",
"PRSS	CafePress Inc.	NASDAQ",
"CLMS	Calamos Asset Management, Inc.	NASDAQ",
"CHY	Calamos Convertible and High Income Fund	NASDAQ",
"CHI	Calamos Convertible Opportunities and Income Fund	NASDAQ",
"CHW	Calamos Global Dynamic Income Fund	NASDAQ",
"CGO	Calamos Global Total Return Fund	NASDAQ",
"CSQ	Calamos Strategic Total Return Fund	NASDAQ",
"CAMP	CalAmp Corp.	NASDAQ",
"CVGW	Calavo Growers, Inc.	NASDAQ",
"CFNB	California First National Bancorp	NASDAQ",
"CALD	Callidus Software, Inc.	NASDAQ",
"CALM	Cal-Maine Foods, Inc.	NASDAQ",
"CLMT	Calumet Specialty Products Partners, L.P.	NASDAQ",
"ABCD	Cambium Learning Group, Inc.	NASDAQ",
"CAMB	CAMBRIDGE CAPITAL ACQUISITION CORPORATION	NASDAQ",
"CAMBU	CAMBRIDGE CAPITAL ACQUISITION CORPORATION	NASDAQ",
"CAMBW	CAMBRIDGE CAPITAL ACQUISITION CORPORATION	NASDAQ",
"CAC	Camden National Corporation	NASDAQ",
"CAMT	Camtek Ltd.	NASDAQ",
"CSIQ	Canadian Solar Inc.	NASDAQ",
"CGIX	Cancer Genetics, Inc.	NASDAQ",
"CPHC	Canterbury Park Holding Corporation	NASDAQ",
"CBNJ	Cape Bancorp, Inc.	NASDAQ",
"CPLA	Capella Education Company	NASDAQ",
"CBF	Capital Bank Financial Corp.	NASDAQ",
"CCBG	Capital City Bank Group	NASDAQ",
"CPLP	Capital Product Partners L.P.	NASDAQ",
"CSWC	Capital Southwest Corporation	NASDAQ",
"CPTA	Capitala Finance Corp.	NASDAQ",
"CLAC	Capitol Acquisition Corp. II	NASDAQ",
"CLACU	Capitol Acquisition Corp. II	NASDAQ",
"CLACW	Capitol Acquisition Corp. II	NASDAQ",
"CFFN	Capitol Federal Financial, Inc.	NASDAQ",
"CPST	Capstone Turbine Corporation	NASDAQ",
"CARA	Cara Therapeutics, Inc.	NASDAQ",
"CARB	Carbonite, Inc.	NASDAQ",
"CRDC	Cardica, Inc.	NASDAQ",
"CFNL	Cardinal Financial Corporation	NASDAQ",
"CRME	Cardiome Pharma Corporation	NASDAQ",
"CSII	Cardiovascular Systems, Inc.	NASDAQ",
"CATM	Cardtronics, Inc.	NASDAQ",
"CECO	Career Education Corporation	NASDAQ",
"CKEC	Carmike Cinemas, Inc.	NASDAQ",
"CLBH	Carolina Bank Holdings Inc.	NASDAQ",
"CART	Carolina Trust Bank	NASDAQ",
"CRZO	Carrizo Oil & Gas, Inc.	NASDAQ",
"TAST	Carrols Restaurant Group, Inc.	NASDAQ",
"CARV	Carver Bancorp, Inc.	NASDAQ",
"CASM	CAS Medical Systems, Inc.	NASDAQ",
"CACB	Cascade Bancorp	NASDAQ",
"CSCD	Cascade Microtech, Inc.	NASDAQ",
"CWST	Casella Waste Systems, Inc.	NASDAQ",
"CASY	Caseys General Stores, Inc.	NASDAQ",
"CASS	Cass Information Systems, Inc	NASDAQ",
"CPRX	Catalyst Pharmaceutical Partners, Inc.	NASDAQ",
"CTRX	Catamaran Corporation	NASDAQ",
"CATY	Cathay General Bancorp	NASDAQ",
"CATYW	Cathay General Bancorp	NASDAQ",
"CVCO	Cavco Industries, Inc.	NASDAQ",
"CAVM	Cavium, Inc.	NASDAQ",
"CBEY	Cbeyond, Inc.	NASDAQ",
"CBOE	CBOE Holdings, Inc.	NASDAQ",
"CDW	CDW Corporation	NASDAQ",
"CECE	CECO Environmental Corp.	NASDAQ",
"CPXX	Celator Pharmaceuticals Inc.	NASDAQ",
"CELG	Celgene Corporation	NASDAQ",
"CELGZ	Celgene Corporation	NASDAQ",
"CTIC	Cell Therapeutics, Inc.	NASDAQ",
"CLDN	Celladon Corporation	NASDAQ",
"CLDX	Celldex Therapeutics, Inc.	NASDAQ",
"ICEL	Cellular Dynamics International, Inc.	NASDAQ",
"CLSN	Celsion Corporation	NASDAQ",
"CLTX	Celsus Therapeutics Plc	NASDAQ",
"CEMP	Cempra, Inc.	NASDAQ",
"CNBC	Center Bancorp, Inc.	NASDAQ",
"CSFL	CenterState Banks, Inc.	NASDAQ",
"CETV	Central European Media Enterprises Ltd.	NASDAQ",
"CFBK	Central Federal Corporation	NASDAQ",
"CENT	Central Garden & Pet Company	NASDAQ",
"CENTA	Central Garden & Pet Company	NASDAQ",
"CVCY	Central Valley Community Bancorp	NASDAQ",
"CENX	Century Aluminum Company	NASDAQ",
"CNBKA	Century Bancorp, Inc.	NASDAQ",
"CNTY	Century Casinos, Inc.	NASDAQ",
"CPHD	CEPHEID	NASDAQ",
"CRNT	Ceragon Networks Ltd.	NASDAQ",
"CERE	Ceres, Inc.	NASDAQ",
"CERN	Cerner Corporation	NASDAQ",
"CERS	Cerus Corporation	NASDAQ",
"KOOL	Cesca Therapeutics Inc.	NASDAQ",
"CEVA	CEVA, Inc.	NASDAQ",
"CYOU	Changyou.com Limited	NASDAQ",
"HOTR	Chanticleer Holdings, Inc.	NASDAQ",
"HOTRW	Chanticleer Holdings, Inc.	NASDAQ",
"CTHR	Charles & Colvard Ltd	NASDAQ",
"CHRM	Charm Communications Inc.	NASDAQ",
"CACG	Chart Acquisition Corp.	NASDAQ",
"CACGU	Chart Acquisition Corp.	NASDAQ",
"CACGW	Chart Acquisition Corp.	NASDAQ",
"GTLS	Chart Industries, Inc.	NASDAQ",
"CHTR	Charter Communications, Inc.	NASDAQ",
"CHFN	Charter Financial Corp.	NASDAQ",
"CHKP	Check Point Software Technologies Ltd.	NASDAQ",
"CHTP	Chelsea Therapeutics International, Ltd.	NASDAQ",
"CEMI	Chembio Diagnostics, Inc.	NASDAQ",
"CHFC	Chemical Financial Corporation	NASDAQ",
"CCXI	ChemoCentryx, Inc.	NASDAQ",
"CHMG	Chemung Financial Corp	NASDAQ",
"CHKE	Cherokee Inc.	NASDAQ",
"CHEV	Cheviot Financial Corp	NASDAQ",
"CBNK	Chicopee Bancorp, Inc.	NASDAQ",
"CMRX	Chimerix, Inc.	NASDAQ",
"CADC	China Advanced Construction Materials Group, Inc.	NASDAQ",
"CALI	China Auto Logistics Inc.	NASDAQ",
"CAAS	China Automotive Systems, Inc.	NASDAQ",
"CBAK	China BAK Battery, Inc.	NASDAQ",
"CBPO	China Biologic Products, Inc.	NASDAQ",
"CCCL	China Ceramics Co., Ltd.	NASDAQ",
"CCCR	China Commercial Credit, Inc.	NASDAQ",
"JRJC	China Finance Online Co. Limited	NASDAQ",
"CHOP	China Gerui Advanced Materials Group Limited	NASDAQ",
"HGSH	China HGS Real Estate, Inc.	NASDAQ",
"CHLN	China Housing & Land Development, Inc.	NASDAQ",
"CNIT	China Information Technology, Inc.	NASDAQ",
"CJJD	China Jo-Jo Drugstores, Inc.	NASDAQ",
"HTHT	China Lodging Group, Limited	NASDAQ",
"CMGE	China Mobile Games and Entertainment Group Limited	NASDAQ",
"CHNR	China Natural Resources, Inc.	NASDAQ",
"CPSL	China Precision Steel, Inc.	NASDAQ",
"CREG	China Recycling Energy Corporation	NASDAQ",
"CPGI	China Shengda Packaging Group, Inc.	NASDAQ",
"CSUN	China Sunergy Co., Ltd.	NASDAQ",
"CNTF	China TechFaith Wireless Communication Technology Limited	NASDAQ",
"CXDC	China XD Plastics Company Limited	NASDAQ",
"CNYD	China Yida Holding, Co.	NASDAQ",
"CCIH	ChinaCache International Holdings Ltd.	NASDAQ",
"CEDU	ChinaEdu Corporation	NASDAQ",
"CNET	ChinaNet Online Holdings, Inc.	NASDAQ",
"CHDX	Chindex International, Inc.	NASDAQ",
"IMOS	ChipMOS TECHNOLOGIES (Bermuda) LTD.	NASDAQ",
"CHSCN	CHS Inc	NASDAQ",
"CHSCO	CHS Inc	NASDAQ",
"CHSCP	CHS Inc	NASDAQ",
"CHDN	Churchill Downs, Incorporated	NASDAQ",
"CHUY	Chuy&#39;s Holdings, Inc.	NASDAQ",
"CHYR	ChyronHego Corporation	NASDAQ",
"CIFC	CIFC Corp.	NASDAQ",
"CIMT	Cimatron, Limited	NASDAQ",
"CINF	Cincinnati Financial Corporation	NASDAQ",
"CIDM	Cinedigm Corp	NASDAQ",
"CTAS	Cintas Corporation	NASDAQ",
"CRUS	Cirrus Logic, Inc.	NASDAQ",
"CISAA	CIS Acquisition Ltd.	NASDAQ",
"CISAU	CIS Acquisition Ltd.	NASDAQ",
"CISAW	CIS Acquisition Ltd.	NASDAQ",
"CSCO	Cisco Systems, Inc.	NASDAQ",
"CTRN	Citi Trends, Inc.	NASDAQ",
"CZNC	Citizens & Northern Corp	NASDAQ",
"CZWI	Citizens Community Bancorp, Inc.	NASDAQ",
"CZFC	Citizens First Corporation	NASDAQ",
"CIZN	Citizens Holding Company	NASDAQ",
"CTXS	Citrix Systems, Inc.	NASDAQ",
"CHCO	City Holding Company	NASDAQ",
"CDTI	Clean Diesel Technologies, Inc.	NASDAQ",
"CLNE	Clean Energy Fuels Corp.	NASDAQ",
"CLNT	Cleantech Solutions International, Inc.	NASDAQ",
"CLFD	Clearfield, Inc.	NASDAQ",
"CLRO	ClearOne, Inc.	NASDAQ",
"CLIR	ClearSign Combustion Corporation	NASDAQ",
"CBLI	Cleveland BioLabs, Inc.	NASDAQ",
"CKSW	ClickSoftware Technologies Ltd.	NASDAQ",
"CSBK	Clifton Bancorp Inc.	NASDAQ",
"CLVS	Clovis Oncology, Inc.	NASDAQ",
"CMFN	CM Finance Inc	NASDAQ",
"CME	CME Group Inc.	NASDAQ",
"CMSB	CMS Bancorp, Inc.	NASDAQ",
"CCNE	CNB Financial Corporation	NASDAQ",
"CISG	CNinsure Inc.	NASDAQ",
"COA           	Coastal Contacts Inc                    	NASDAQ",
"CWAY	Coastway Bancorp, Inc.	NASDAQ",
"COBZ	CoBiz Financial Inc.	NASDAQ",
"COBR	Cobra Electronics Corporation	NASDAQ",
"COKE	Coca-Cola Bottling Co. Consolidated	NASDAQ",
"CDXS	Codexis, Inc.	NASDAQ",
"CVLY	Codorus Valley Bancorp, Inc	NASDAQ",
"JVA	Coffee Holding Co., Inc.	NASDAQ",
"CCOI	Cogent Communications Group, Inc.	NASDAQ",
"CGNX	Cognex Corporation	NASDAQ",
"CTSH	Cognizant Technology Solutions Corporation	NASDAQ",
"COHR	Coherent, Inc.	NASDAQ",
"COHU	Cohu, Inc.	NASDAQ",
"CWTR	Coldwater Creek, Inc.	NASDAQ",
"JACQ	COLLABRIUM JAPAN ACQUISITION CORPORATION	NASDAQ",
"JACQU	COLLABRIUM JAPAN ACQUISITION CORPORATION	NASDAQ",
"JACQW	COLLABRIUM JAPAN ACQUISITION CORPORATION	NASDAQ",
"CLRX	CollabRx, Inc.	NASDAQ",
"CLCT	Collectors Universe, Inc.	NASDAQ",
"COBK	Colonial Financial Services, Inc.	NASDAQ",
"CBAN	Colony Bankcorp, Inc.	NASDAQ",
"COLB	Columbia Banking System, Inc.	NASDAQ",
"CBRX	Columbia Laboratories, Inc.	NASDAQ",
"COLM	Columbia Sportswear Company	NASDAQ",
"CMCO	Columbus McKinnon Corporation	NASDAQ",
"CBMX	CombiMatrix Corporation	NASDAQ",
"CBMXW	CombiMatrix Corporation	NASDAQ",
"CMCSA	Comcast Corporation	NASDAQ",
"CMCSK	Comcast Corporation	NASDAQ",
"CBSH	Commerce Bancshares, Inc.	NASDAQ",
"CVGI	Commercial Vehicle Group, Inc.	NASDAQ",
"COMM	CommScope Holding Company, Inc.	NASDAQ",
"JCS	Communications Systems, Inc.	NASDAQ",
"CBIN	Community Bank Shares of Indiana, Inc.	NASDAQ",
"ESXB	Community Bankers Trust Corporation.	NASDAQ",
"CYHHZ	Community Health Systems, Inc.	NASDAQ",
"CTBI	Community Trust Bancorp, Inc.	NASDAQ",
"CWBC	Community West Bancshares	NASDAQ",
"COB	CommunityOne Bancorp	NASDAQ",
"CVLT	CommVault Systems, Inc.	NASDAQ",
"GSJK	Compressco Partners, L.P.	NASDAQ",
"CGEN	Compugen Ltd.	NASDAQ",
"CPSI	Computer Programs and Systems, Inc.	NASDAQ",
"CTG	Computer Task Group, Incorporated	NASDAQ",
"CPWR	Compuware Corporation	NASDAQ",
"SCOR	comScore, Inc.	NASDAQ",
"CHCI	Comstock Holding Companies, Inc.	NASDAQ",
"CMTL	Comtech Telecommunications Corp.	NASDAQ",
"CNSI	Comverse Inc.	NASDAQ",
"CNAT	Conatus Pharmaceuticals Inc.	NASDAQ",
"CNCE	Concert Pharmaceuticals, Inc.	NASDAQ",
"CNQR	Concur Technologies, Inc.	NASDAQ",
"CCUR	Concurrent Computer Corporation	NASDAQ",
"CNMD	CONMED Corporation	NASDAQ",
"CTWS	Connecticut Water Service, Inc.	NASDAQ",
"CNOB	ConnectOne Bancorp, Inc.	NASDAQ",
"CONN	Conn&#39;s, Inc.	NASDAQ",
"CNSL	Consolidated Communications Holdings, Inc.	NASDAQ",
"CWCO	Consolidated Water Co. Ltd.	NASDAQ",
"CTCT	Constant Contact, Inc.	NASDAQ",
"CPSS	Consumer Portfolio Services, Inc.	NASDAQ",
"CTRL	Control4 Corporation	NASDAQ",
"CNVR	Conversant, Inc.	NASDAQ",
"CPRT	Copart, Inc.	NASDAQ",
"CORT	Corcept Therapeutics Incorporated	NASDAQ",
"BVA	Cordia Bancorp Inc.	NASDAQ",
"CORE	Core-Mark Holding Company, Inc.	NASDAQ",
"COCO	Corinthian Colleges, Inc.	NASDAQ",
"CORI	Corium International, Inc.	NASDAQ",
"CSOD	Cornerstone OnDemand, Inc.	NASDAQ",
"CNDO	Coronado Biosciences, Inc.	NASDAQ",
"CRRS	Corporate Resource Services, Inc.	NASDAQ",
"CRVL	CorVel Corp.	NASDAQ",
"COSI	Cosi, Inc.	NASDAQ",
"CSGP	CoStar Group, Inc.	NASDAQ",
"COST	Costco Wholesale Corporation	NASDAQ",
"CPAH	CounterPath Corporation	NASDAQ",
"CRRC	Courier Corporation	NASDAQ",
"CVTI	Covenant Transportation Group, Inc.	NASDAQ",
"COVS	Covisint Corporation	NASDAQ",
"COWN	Cowen Group, Inc.	NASDAQ",
"CRAI	CRA International,Inc.	NASDAQ",
"CBRL	Cracker Barrel Old Country Store, Inc.	NASDAQ",
"BREW	Craft Brew Alliance, Inc.	NASDAQ",
"CRAY	Cray Inc	NASDAQ",
"CACC	Credit Acceptance Corporation	NASDAQ",
"DGLD	Credit Suisse AG	NASDAQ",
"DSLV	Credit Suisse AG	NASDAQ",
"GLDI	Credit Suisse AG	NASDAQ",
"SLVO	Credit Suisse AG	NASDAQ",
"TVIX	Credit Suisse AG	NASDAQ",
"UGLD	Credit Suisse AG	NASDAQ",
"USLV	Credit Suisse AG	NASDAQ",
"VIIX	Credit Suisse AG	NASDAQ",
"VIIZ	Credit Suisse AG	NASDAQ",
"XIV	Credit Suisse AG	NASDAQ",
"ZIV	Credit Suisse AG	NASDAQ",
"CREE	Cree, Inc.	NASDAQ",
"CRESW	Cresud S.A.C.I.F. y A.	NASDAQ",
"CRESY	Cresud S.A.C.I.F. y A.	NASDAQ",
"CRTO	Criteo S.A.	NASDAQ",
"CROX	Crocs, Inc.	NASDAQ",
"CCRN	Cross Country Healthcare, Inc.	NASDAQ",
"CRDS	Crossroads Systems, Inc.	NASDAQ",
"CRWS	Crown Crafts, Inc.	NASDAQ",
"CRWN	Crown Media Holdings, Inc.	NASDAQ",
"CRMB	Crumbs Bake Shop, Inc.	NASDAQ",
"CRMBU	Crumbs Bake Shop, Inc.	NASDAQ",
"CRMBW	Crumbs Bake Shop, Inc.	NASDAQ",
"CSGS	CSG Systems International, Inc.	NASDAQ",
"CSPI	CSP Inc.	NASDAQ",
"CSRE	CSR plc	NASDAQ",
"CTCM	CTC Media, Inc.	NASDAQ",
"CTIB	CTI Industries Corporation	NASDAQ",
"CTRP	Ctrip.com International, Ltd.	NASDAQ",
"CUNB	CU Bancorp (CA)	NASDAQ",
"CBST	Cubist Pharmaceuticals, Inc.	NASDAQ",
"CBSTZ	Cubist Pharmaceuticals, Inc.	NASDAQ",
"CUI	CUI Global, Inc.	NASDAQ",
"CPIX	Cumberland Pharmaceuticals Inc.	NASDAQ",
"CMLS	Cumulus Media Inc.	NASDAQ",
"CRIS	Curis, Inc.	NASDAQ",
"CUBI	Customers Bancorp, Inc	NASDAQ",
"CUBIL	Customers Bancorp, Inc	NASDAQ",
"CUTR	Cutera, Inc.	NASDAQ",
"CVBF	CVB Financial Corporation	NASDAQ",
"CVV	CVD Equipment Corporation	NASDAQ",
"CYAN	Cyanotech Corporation	NASDAQ",
"CYBX	Cyberonics, Inc.	NASDAQ",
"CYBE	CyberOptics Corporation	NASDAQ",
"CYCC	Cyclacel Pharmaceuticals, Inc.	NASDAQ",
"CYCCP	Cyclacel Pharmaceuticals, Inc.	NASDAQ",
"CYNO	Cynosure, Inc.	NASDAQ",
"CY	Cypress Semiconductor Corporation	NASDAQ",
"CYRN	CYREN Ltd.	NASDAQ",
"CONE	CyrusOne Inc	NASDAQ",
"CYTK	Cytokinetics, Incorporated	NASDAQ",
"CYTX	Cytori Therapeutics Inc	NASDAQ",
"CYTXW	Cytori Therapeutics Inc	NASDAQ",
"CYTR	CytRx Corporation	NASDAQ",
"DAEG	Daegis Inc	NASDAQ",
"DJCO	Daily Journal Corp. (S.C.)	NASDAQ",
"DAKT	Daktronics, Inc.	NASDAQ",
"DARA	DARA Biosciences, Inc.	NASDAQ",
"DAIO	Data I/O Corporation	NASDAQ",
"DTLK	Datalink Corporation	NASDAQ",
"DRAM	Dataram Corporation	NASDAQ",
"DWCH	Datawatch Corporation	NASDAQ",
"DWSN	Dawson Geophysical Company	NASDAQ",
"TRAK	Dealertrack Technologies, Inc.	NASDAQ",
"DECK	Deckers Outdoor Corporation	NASDAQ",
"DHRM	Dehaier Medical Systems Limited	NASDAQ",
"DFRG	Del Frisco&#39;s Restaurant Group, Inc.	NASDAQ",
"DCTH	Delcath Systems, Inc.	NASDAQ",
"DLIA	dELIA*s Inc.	NASDAQ",
"DGAS	Delta Natural Gas Company, Inc.	NASDAQ",
"DNDN	Dendreon Corporation	NASDAQ",
"DENN	Denny&#39;s Corporation	NASDAQ",
"XRAY	DENTSPLY International Inc.	NASDAQ",
"DEPO	Depomed, Inc.	NASDAQ",
"DSCI	Derma Sciences, Inc.	NASDAQ",
"DEST	Destination Maternity Corporation	NASDAQ",
"DXLG	Destination XL Group, Inc.	NASDAQ",
"DSWL	Deswell Industries, Inc.	NASDAQ",
"DXM	Dex Media, Inc.	NASDAQ",
"DXCM	DexCom, Inc.	NASDAQ",
"DLLR	DFC Global Corp	NASDAQ",
"DMND	Diamond Foods, Inc.	NASDAQ",
"DHIL	Diamond Hill Investment Group, Inc.	NASDAQ",
"FANG	Diamondback Energy, Inc.	NASDAQ",
"DCIX	Diana Containerships Inc.	NASDAQ",
"DRNA	Dicerna Pharmaceuticals, Inc.	NASDAQ",
"DGII	Digi International Inc.	NASDAQ",
"DMRC	Digimarc Corporation	NASDAQ",
"DRAD	Digirad Corporation	NASDAQ",
"DGLY	Digital Ally, Inc.	NASDAQ",
"DCIN	Digital Cinema Destinations Corp.	NASDAQ",
"DRIV	Digital River, Inc.	NASDAQ",
"DCOM	Dime Community Bancshares, Inc.	NASDAQ",
"DIOD	Diodes Incorporated	NASDAQ",
"DPRX	Dipexium Pharmaceuticals, Inc.	NASDAQ",
"DTV	DIRECTV	NASDAQ",
"DISCA	Discovery Communications, Inc.	NASDAQ",
"DISCB	Discovery Communications, Inc.	NASDAQ",
"DISCK	Discovery Communications, Inc.	NASDAQ",
"DSCO	Discovery Laboratories, Inc.	NASDAQ",
"DISH	DISH Network Corporation	NASDAQ",
"DVCR	Diversicare Healthcare Services Inc.	NASDAQ",
"BAGR	Diversified Restaurant Holdings, Inc.	NASDAQ",
"DLHC	DLH Holdings Corp.	NASDAQ",
"DNBF	DNB Financial Corp	NASDAQ",
"DLTR	Dollar Tree, Inc.	NASDAQ",
"DGICA	Donegal Group, Inc.	NASDAQ",
"DGICB	Donegal Group, Inc.	NASDAQ",
"DMLP	Dorchester Minerals, L.P.	NASDAQ",
"DORM	Dorman Products, Inc.	NASDAQ",
"HILL	Dot Hill Systems Corporation	NASDAQ",
"DOVR	Dover Saddlery, Inc.	NASDAQ",
"DRWI	DragonWave Inc	NASDAQ",
"DWA	Dreamworks Animation SKG, Inc.	NASDAQ",
"DRYS	DryShips Inc.	NASDAQ",
"DSKX	DS Healthcare Group, Inc.	NASDAQ",
"DSPG	DSP Group, Inc.	NASDAQ",
"DTSI	DTS, Inc.	NASDAQ",
"DNKN	Dunkin&#39; Brands Group, Inc.	NASDAQ",
"DRTX	Durata Therapeutics, Inc.	NASDAQ",
"DRRX	Durect Corporation	NASDAQ",
"DXPE	DXP Enterprises, Inc.	NASDAQ",
"DYAX	Dyax Corp.	NASDAQ",
"DLNG	Dynagas LNG Partners LP	NASDAQ",
"BOOM	Dynamic Materials Corporation	NASDAQ",
"DYSL	Dynasil Corporation of America	NASDAQ",
"DYNT	Dynatronics Corporation	NASDAQ",
"DVAX	Dynavax Technologies Corporation	NASDAQ",
"ETFC	E*TRADE Financial Corporation	NASDAQ",
"EOPN	E2open, Inc.	NASDAQ",
"EBMT	Eagle Bancorp Montana, Inc.	NASDAQ",
"EGBN	Eagle Bancorp, Inc.	NASDAQ",
"EGLE	Eagle Bulk Shipping Inc.	NASDAQ",
"EGRX	Eagle Pharmaceuticals, Inc.	NASDAQ",
"EROC	Eagle Rock Energy Partners, L.P.	NASDAQ",
"ELNK	EarthLink Holdings Corp.	NASDAQ",
"EWBC	East West Bancorp, Inc.	NASDAQ",
"EML	Eastern Company (The)	NASDAQ",
"EVBS	Eastern Virginia Bankshares, Inc.	NASDAQ",
"EBAY	eBay Inc.	NASDAQ",
"EBIX	Ebix, Inc.	NASDAQ",
"ELON	Echelon Corporation	NASDAQ",
"ECHO	Echo Global Logistics, Inc.	NASDAQ",
"ECTE	Echo Therapeutics, Inc.	NASDAQ",
"SATS	EchoStar Corporation	NASDAQ",
"EEI	Ecology and Environment, Inc.	NASDAQ",
"EDAP	EDAP TMS S.A.	NASDAQ",
"EDGW	Edgewater Technology, Inc.	NASDAQ",
"EDMC	Education Management Corporation	NASDAQ",
"EDUC	Educational Development Corporation	NASDAQ",
"EFUT	eFuture Information Technology Inc.	NASDAQ",
"EGAN	eGain Corporation	NASDAQ",
"EGLT	Egalet Corporation	NASDAQ",
"EHTH	eHealth, Inc.	NASDAQ",
"BAGL	Einstein Noah Restaurant Group, Inc.	NASDAQ",
"EMITF	Elbit Imaging Ltd.	NASDAQ",
"ESLT	Elbit Systems Ltd.	NASDAQ",
"ESYS	Elecsys Corporation	NASDAQ",
"ELRC	Electro Rent Corporation	NASDAQ",
"ESIO	Electro Scientific Industries, Inc.	NASDAQ",
"EA	Electronic Arts Inc.	NASDAQ",
"EFII	Electronics for Imaging, Inc.	NASDAQ",
"ELSE	Electro-Sensors, Inc.	NASDAQ",
"EBIO	Eleven Biotherapeutics, Inc.	NASDAQ",
"RDEN	Elizabeth Arden, Inc.	NASDAQ",
"ESBK	Elmira Savings Bank NY (The)	NASDAQ",
"LONG	eLong, Inc.	NASDAQ",
"ELTK	Eltek Ltd.	NASDAQ",
"EMCI	EMC Insurance Group, Inc.	NASDAQ",
"EMCF	Emclaire Financial Corp	NASDAQ",
"EMKR	EMCORE Corporation	NASDAQ",
"EMMS	Emmis Communications Corporation	NASDAQ",
"EMMSP	Emmis Communications Corporation	NASDAQ",
"NYNY	Empire Resorts, Inc.	NASDAQ",
"ERS	Empire Resources, Inc.	NASDAQ",
"ENTA	Enanta Pharmaceuticals, Inc.	NASDAQ",
"ECPG	Encore Capital Group Inc	NASDAQ",
"WIRE	Encore Wire Corporation	NASDAQ",
"ENDP	Endo International plc	NASDAQ",
"ECYT	Endocyte, Inc.	NASDAQ",
"ELGX	Endologix, Inc.	NASDAQ",
"EIGI	Endurance International Group Holdings, Inc.	NASDAQ",
"WATT	Energous Corporation	NASDAQ",
"ERII	Energy Recovery, Inc.	NASDAQ",
"EXXI	Energy XXI (Bermuda) Limited	NASDAQ",
"ENOC	EnerNOC, Inc.	NASDAQ",
"ENG	ENGlobal Corporation	NASDAQ",
"ENPH	Enphase Energy, Inc.	NASDAQ",
"ESGR	Enstar Group Limited	NASDAQ",
"ENTG	Entegris, Inc.	NASDAQ",
"ETRM	EnteroMedics Inc.	NASDAQ",
"EBTC	Enterprise Bancorp Inc	NASDAQ",
"EFSC	Enterprise Financial Services Corporation	NASDAQ",
"EGT	Entertainment Gaming Asia Incorporated	NASDAQ",
"ENMD	EntreMed, Inc.	NASDAQ",
"ENTR	Entropic Communications, Inc.	NASDAQ",
"ENVI	Envivio, Inc.	NASDAQ",
"ENZN	Enzon Pharmaceuticals, Inc.	NASDAQ",
"ENZY          	Enzymotec Ltd.	NASDAQ",
"EONC	eOn Communications Corporation	NASDAQ",
"EPIQ	EPIQ Systems, Inc.	NASDAQ",
"EPZM	Epizyme, Inc.	NASDAQ",
"PLUS	ePlus inc.	NASDAQ",
"EQIX	Equinix, Inc.	NASDAQ",
"EAC           	Erickson Air-Crane Incorporated	NASDAQ",
"ERIC	Ericsson	NASDAQ",
"ERIE	Erie Indemnity Company	NASDAQ",
"ESBF	ESB Financial Corporation	NASDAQ",
"ESCA	Escalade, Incorporated	NASDAQ",
"ESCR	Escalera Resources Co.	NASDAQ",
"ESCRP	Escalera Resources Co.	NASDAQ",
"ESMC	Escalon Medical Corp.	NASDAQ",
"ESPR	Esperion Therapeutics, Inc.	NASDAQ",
"ESSA	ESSA Bancorp, Inc.	NASDAQ",
"ESSX	Essex Rental Corporation	NASDAQ",
"CLWT	Euro Tech Holdings Company Limited	NASDAQ",
"EEFT	Euronet Worldwide, Inc.	NASDAQ",
"ESEA	Euroseas Ltd.	NASDAQ",
"EVEP	EV Energy Partners, L.P.	NASDAQ",
"EVRY	EveryWare Global, Inc.	NASDAQ",
"EVOK	Evoke Pharma, Inc.	NASDAQ",
"EVOL	Evolving Systems, Inc.	NASDAQ",
"EXA	Exa Corporation	NASDAQ",
"EXAS	EXACT Sciences Corporation	NASDAQ",
"EXAC	Exactech, Inc.	NASDAQ",
"EDS	Exceed Company Ltd.	NASDAQ",
"EXEL	Exelixis, Inc.	NASDAQ",
"EXFO	EXFO Inc	NASDAQ",
"EXLS	ExlService Holdings, Inc.	NASDAQ",
"EXPE	Expedia, Inc.	NASDAQ",
"EXPD	Expeditors International of Washington, Inc.	NASDAQ",
"EXPO	Exponent, Inc.	NASDAQ",
"ESRX	Express Scripts Holding Company	NASDAQ",
"EXLP	Exterran Partners, L.P.	NASDAQ",
"EXTR	Extreme Networks, Inc.	NASDAQ",
"EZCH	EZchip Semiconductor Limited	NASDAQ",
"EZPW	EZCORP, Inc.	NASDAQ",
"FFIV	F5 Networks, Inc.	NASDAQ",
"FB	Facebook, Inc.	NASDAQ",
"FCS	Fairchild Semiconductor International, Inc.	NASDAQ",
"FRP	FairPoint Communications, Inc.	NASDAQ",
"FWM	Fairway Group Holdings Corp.	NASDAQ",
"FALC	FalconStor Software, Inc.	NASDAQ",
"DAVE	Famous Dave&#39;s of America, Inc.	NASDAQ",
"FARM	Farmer Brothers Company	NASDAQ",
"FFKT	Farmers Capital Bank Corporation	NASDAQ",
"FMNB	Farmers National Banc Corp.	NASDAQ",
"FARO	FARO Technologies, Inc.	NASDAQ",
"FAST	Fastenal Company	NASDAQ",
"FATE	Fate Therapeutics, Inc.	NASDAQ",
"FBSS	Fauquier Bankshares, Inc.	NASDAQ",
"FBRC	FBR & Co	NASDAQ",
"FDML	Federal-Mogul Corporation	NASDAQ",
"FNHC	Federated National Holding Company	NASDAQ",
"FFCO	FedFirst Financial Corporation	NASDAQ",
"FEIC	FEI Company	NASDAQ",
"FHCO	Female Health Company (The)	NASDAQ",
"ONEQ	Fidelity Nasdaq Composite Index Tracking Stock	NASDAQ",
"LION	Fidelity Southern Corporation	NASDAQ",
"FDUS	Fidus Investment Corporation	NASDAQ",
"FRGI	Fiesta Restaurant Group, Inc.	NASDAQ",
"FSC	Fifth Street Finance Corp.	NASDAQ",
"FSCFL	Fifth Street Finance Corp.	NASDAQ",
"FSFR	Fifth Street Senior Floating Rate Corp.	NASDAQ",
"FITB	Fifth Third Bancorp	NASDAQ",
"FITBI	Fifth Third Bancorp	NASDAQ",
"FNGN	Financial Engines, Inc.	NASDAQ",
"FISI	Financial Institutions, Inc.	NASDAQ",
"FNSR	Finisar Corporation	NASDAQ",
"FEYE	FireEye, Inc.	NASDAQ",
"FBNC	First Bancorp	NASDAQ",
"FNLC	First Bancorp, Inc (ME)	NASDAQ",
"FRBA	First Bank	NASDAQ",
"BUSE	First Busey Corporation	NASDAQ",
"FBIZ	First Business Financial Services, Inc.	NASDAQ",
"FCVA	First Capital Bancorp, Inc. (VA)	NASDAQ",
"FCAP	First Capital, Inc.	NASDAQ",
"FCFS	First Cash Financial Services, Inc.	NASDAQ",
"FCZA	First Citizens Banc Corp.	NASDAQ",
"FCZAP	First Citizens Banc Corp.	NASDAQ",
"FCNCA	First Citizens BancShares, Inc.	NASDAQ",
"FCLF	First Clover Leaf Financial Corp.	NASDAQ",
"FCBC	First Community Bancshares, Inc.	NASDAQ",
"FCCO	First Community Corporation	NASDAQ",
"FBNK	First Connecticut Bancorp, Inc.	NASDAQ",
"FDEF	First Defiance Financial Corp.	NASDAQ",
"FFBH	First Federal Bancshares of Arkansas, Inc.	NASDAQ",
"FFNM	First Federal of Northern Michigan Bancorp, Inc.	NASDAQ",
"FFBC	First Financial Bancorp.	NASDAQ",
"FFBCW	First Financial Bancorp.	NASDAQ",
"FFIN	First Financial Bankshares, Inc.	NASDAQ",
"THFF	First Financial Corporation Indiana	NASDAQ",
"SCBT	First Financial Holdings, Inc.	NASDAQ",
"FFNW	First Financial Northwest, Inc.	NASDAQ",
"FFKY	First Financial Service Corporation	NASDAQ",
"INBK	First Internet Bancorp	NASDAQ",
"FIBK	First Interstate BancSystem, Inc.	NASDAQ",
"FRME	First Merchants Corporation	NASDAQ",
"FMBI	First Midwest Bancorp, Inc.	NASDAQ",
"NBCB	First NBC Bank Holding Company	NASDAQ",
"FNFG	First Niagara Financial Group Inc.	NASDAQ",
"FSFG	First Savings Financial Group, Inc.	NASDAQ",
"FSGI	First Security Group, Inc.	NASDAQ",
"FSLR	First Solar, Inc.	NASDAQ",
"FSBK	First South Bancorp Inc	NASDAQ",
"BICK	First Trust BICK Index Fund	NASDAQ",
"FTCS	First Trust Capital Strength ETF	NASDAQ",
"FV	First Trust Dorsey Wright Focus 5 ETF	NASDAQ",
"TDIV	First Trust Exchange-Traded Fund VI First Trust NASDAQ Technol	NASDAQ",
"MDIV	First Trust Exchange-Traded Fund VI Multi-Asset Diversified In	NASDAQ",
"FTGC	First Trust Global Tactical Commodity Strategy Fund	NASDAQ",
"FTHI	First Trust High Income ETF	NASDAQ",
"HYLS	First Trust High Yield Long/Short ETF	NASDAQ",
"YDIV	First Trust International Multi-Asset Diversified Income Index	NASDAQ",
"SKYY	First Trust ISE Cloud Computing Index Fund	NASDAQ",
"CU	First Trust ISE Global Copper Index Fund	NASDAQ",
"PLTM	First Trust ISE Global Platinum Index Fund	NASDAQ",
"FTLB	First Trust Low Beta Income ETF	NASDAQ",
"QABA	First Trust NASDAQ ABA Community Bank Index Fund	NASDAQ",
"FONE	First Trust NASDAQ CEA Smartphone Index Fund	NASDAQ",
"GRID	First Trust NASDAQ Clean Edge Smart Grid Infrastructure Index 	NASDAQ",
"QCLN	First Trust NASDAQ Clean Edge U.S. Liquid Series Index Fund	NASDAQ",
"CARZ	First Trust NASDAQ Global Auto Index Fund	NASDAQ",
"RDVY	First Trust NASDAQ Rising Dividend Achievers ETF	NASDAQ",
"QQEW	First Trust NASDAQ-100 Equal Weighted Index Fund	NASDAQ",
"QQXT	First Trust NASDAQ-100 Ex-Technology Sector Index Fund	NASDAQ",
"QTEC	First Trust NASDAQ-100-Technology Sector Index Fund	NASDAQ",
"AIRR	First Trust RBA American Industrial Renaissance ETF	NASDAQ",
"QINC	First Trust RBA Quality Income ETF	NASDAQ",
"FTSL	First Trust Senior Loan Fund ETF	NASDAQ",
"FUNC	First United Corporation	NASDAQ",
"FBMI	Firstbank Corporation	NASDAQ",
"SVVC	Firsthand Technology Value Fund, Inc.	NASDAQ",
"FMER	FirstMerit Corporation	NASDAQ",
"FSRV	FirstService Corporation	NASDAQ",
"FISV	Fiserv, Inc.	NASDAQ",
"FIVE	Five Below, Inc.	NASDAQ",
"FPRX	Five Prime Therapeutics, Inc.	NASDAQ",
"FLML	Flamel Technologies S.A.	NASDAQ",
"FLXN	Flexion Therapeutics, Inc.	NASDAQ",
"FLXS	Flexsteel Industries, Inc.	NASDAQ",
"FLEX	Flextronics International Ltd.	NASDAQ",
"FLIR	FLIR Systems, Inc.	NASDAQ",
"FLDM	Fluidigm Corporation	NASDAQ",
"FFIC	Flushing Financial Corporation	NASDAQ",
"FONR	Fonar Corporation	NASDAQ",
"FES	Forbes Energy Services Ltd	NASDAQ",
"FNRG	ForceField Energy Inc.	NASDAQ",
"FORM	FormFactor, Inc.	NASDAQ",
"FORTY	Formula Systems (1985) Ltd.	NASDAQ",
"FORR	Forrester Research, Inc.	NASDAQ",
"FTNT	Fortinet, Inc.	NASDAQ",
"FWRD	Forward Air Corporation	NASDAQ",
"FORD	Forward Industries, Inc.	NASDAQ",
"FOSL	Fossil Group, Inc.	NASDAQ",
"FWLT	Foster Wheeler AG.	NASDAQ",
"FMI	Foundation Medicine, Inc.	NASDAQ",
"FXCB	Fox Chase Bancorp, Inc.	NASDAQ",
"FOXF	Fox Factory Holding Corp.	NASDAQ",
"FRAN	Francesca&#39;s Holdings Corporation	NASDAQ",
"FELE	Franklin Electric Co., Inc.	NASDAQ",
"FRNK	Franklin Financial Corporation	NASDAQ",
"FRED	Fred&#39;s, Inc.	NASDAQ",
"FREE	FreeSeas Inc.	NASDAQ",
"RAIL	Freightcar America, Inc.	NASDAQ",
"FEIM	Frequency Electronics, Inc.	NASDAQ",
"FTR	Frontier Communications Corporation	NASDAQ",
"FSBW	FS Bancorp, Inc.	NASDAQ",
"FTD	FTD Companies, Inc.	NASDAQ",
"FSYS	Fuel Systems Solutions, Inc.	NASDAQ",
"FTEK	Fuel Tech, Inc.	NASDAQ",
"FCEL	FuelCell Energy, Inc.	NASDAQ",
"FULL	Full Circle Capital Corporation	NASDAQ",
"FULLL	Full Circle Capital Corporation	NASDAQ",
"FLL	Full House Resorts, Inc.	NASDAQ",
"FULT	Fulton Financial Corporation	NASDAQ",
"FURX	Furiex Pharmaceuticals, Inc.	NASDAQ",
"FFHL	Fuwei Films (Holdings) Co., Ltd.	NASDAQ",
"FXEN	FX Energy, Inc.	NASDAQ",
"GK	G&K Services, Inc.	NASDAQ",
"WILC	G. Willi-Food International,  Ltd.	NASDAQ",
"GAIA	Gaiam, Inc.	NASDAQ",
"GALT	Galectin Therapeutics Inc.	NASDAQ",
"GALTU	Galectin Therapeutics Inc.	NASDAQ",
"GALTW	Galectin Therapeutics Inc.	NASDAQ",
"GALE	Galena Biopharma, Inc.	NASDAQ",
"GLMD	Galmed Pharmaceuticals Ltd.	NASDAQ",
"GLPI	Gaming and Leisure Properties, Inc.	NASDAQ",
"GPIC	Gaming Partners International Corporation	NASDAQ",
"GRMN	Garmin Ltd.	NASDAQ",
"GARS	Garrison Capital Inc.	NASDAQ",
"GKNT	Geeknet, Inc.	NASDAQ",
"GENC	Gencor Industries Inc.	NASDAQ",
"GNCMA	General Communication, Inc.	NASDAQ",
"GFN	General Finance Corporation	NASDAQ",
"GFNCP	General Finance Corporation	NASDAQ",
"GENE	Genetic Technologies Ltd	NASDAQ",
"GNMK	GenMark Diagnostics, Inc.	NASDAQ",
"GNCA	Genocea Biosciences, Inc.	NASDAQ",
"GHDX	Genomic Health, Inc.	NASDAQ",
"GNTX	Gentex Corporation	NASDAQ",
"THRM	Gentherm Inc	NASDAQ",
"GTIV	Gentiva Health Services, Inc.	NASDAQ",
"GNVC	GenVec, Inc.	NASDAQ",
"GMETP	GeoMet, Inc.	NASDAQ",
"GTWN	Georgetown Bancorp, Inc.	NASDAQ",
"GEOS	Geospace Technologies Corporation	NASDAQ",
"GABC	German American Bancorp, Inc.	NASDAQ",
"GERN	Geron Corporation	NASDAQ",
"GEVO	Gevo, Inc.	NASDAQ",
"ROCK	Gibraltar Industries, Inc.	NASDAQ",
"GIGM	GigaMedia Limited	NASDAQ",
"GIGA	Giga-tronics Incorporated	NASDAQ",
"GIII	G-III Apparel Group, LTD.	NASDAQ",
"GILT	Gilat Satellite Networks Ltd.	NASDAQ",
"GILD	Gilead Sciences, Inc.	NASDAQ",
"GBCI	Glacier Bancorp, Inc.	NASDAQ",
"GLAD	Gladstone Capital Corporation	NASDAQ",
"GLADP	Gladstone Capital Corporation	NASDAQ",
"GOOD	Gladstone Commercial Corporation	NASDAQ",
"GOODN	Gladstone Commercial Corporation	NASDAQ",
"GOODO	Gladstone Commercial Corporation	NASDAQ",
"GOODP	Gladstone Commercial Corporation	NASDAQ",
"GAIN	Gladstone Investment Corporation	NASDAQ",
"GAINP	Gladstone Investment Corporation	NASDAQ",
"LAND	Gladstone Land Corporation	NASDAQ",
"GLCH	Gleacher & Company, Inc.	NASDAQ",
"GLBZ	Glen Burnie Bancorp	NASDAQ",
"GDEF	Global Defense & National Security Systems, Inc.	NASDAQ",
"ENT	Global Eagle Entertainment Inc.	NASDAQ",
"GBLI	Global Indemnity plc	NASDAQ",
"GLPW	Global Power Equipment Group Inc	NASDAQ",
"GSOL	Global Sources Ltd.	NASDAQ",
"QQQC	Global X NASDAQ China Technology ETF	NASDAQ",
"SOCL	Global X Social Media Index ETF	NASDAQ",
"GAI	Global-Tech Advanced Innovations Inc.	NASDAQ",
"GSM	Globe Specialty Metals Inc.	NASDAQ",
"GLBS	Globus Maritime Limited	NASDAQ",
"GLUU	Glu Mobile Inc.	NASDAQ",
"GLYC	GlycoMimetics, Inc.	NASDAQ",
"GOGO	Gogo Inc.	NASDAQ",
"GLNG	Golar LNG Limited	NASDAQ",
"GMLP	Golar LNG Partners LP	NASDAQ",
"GLDC	Golden Enterprises, Inc.	NASDAQ",
"GBDC	Golub Capital BDC, Inc.	NASDAQ",
"GTIM	Good Times Restaurants Inc.	NASDAQ",
"GOOG	Google Inc.	NASDAQ",
"GOOGL	Google Inc.	NASDAQ",
"GMAN	Gordmans Stores, Inc.	NASDAQ",
"LOPE	Grand Canyon Education, Inc.	NASDAQ",
"GRVY	GRAVITY Co., Ltd.	NASDAQ",
"GLDD	Great Lakes Dredge & Dock Corporation	NASDAQ",
"GSBC	Great Southern Bancorp, Inc.	NASDAQ",
"GPRE	Green Plains Renewable Energy, Inc.	NASDAQ",
"GCBC	Greene County Bancorp, Inc.	NASDAQ",
"GLRE	Greenlight Reinsurance, Ltd.	NASDAQ",
"GRIF	Griffin Land & Nurseries, Inc.	NASDAQ",
"GRFS	Grifols, S.A.	NASDAQ",
"GRPN	Groupon, Inc.	NASDAQ",
"OMAB	Grupo Aeroportuario del Centro Norte S.A.B. de C.V.	NASDAQ",
"GGAL	Grupo Financiero Galicia S.A.	NASDAQ",
"GSIG	GSI Group, Inc.	NASDAQ",
"GSIT	GSI Technology, Inc.	NASDAQ",
"GSVC	GSV Capital Corp	NASDAQ",
"GTAT	GT Advanced Technologies, Inc.	NASDAQ",
"GTXI	GTx, Inc.	NASDAQ",
"GPRC	Guanwei Recycling Corp.	NASDAQ",
"GBNK	Guaranty Bancorp	NASDAQ",
"GFED	Guaranty Federal Bancshares, Inc.	NASDAQ",
"GUID	Guidance Software, Inc.	NASDAQ",
"GIFI	Gulf Island Fabrication, Inc.	NASDAQ",
"GURE	Gulf Resources, Inc.	NASDAQ",
"GPOR	Gulfport Energy Corporation	NASDAQ",
"GWPH	GW Pharmaceuticals Plc	NASDAQ",
"GYRO	Gyrodyne Company of America, Inc.	NASDAQ",
"HEES	H&E Equipment Services, Inc.	NASDAQ",
"HNRG	Hallador Energy Company	NASDAQ",
"HALL	Hallmark Financial Services, Inc.	NASDAQ",
"HALO	Halozyme Therapeutics, Inc.	NASDAQ",
"HBK	Hamilton Bancorp, Inc.	NASDAQ",
"HBNK	Hampden Bancorp, Inc.	NASDAQ",
"HMPR	Hampton Roads Bankshares Inc	NASDAQ",
"HBHC	Hancock Holding Company	NASDAQ",
"HNH	Handy & Harman Ltd.	NASDAQ",
"HAFC	Hanmi Financial Corporation	NASDAQ",
"HNSN	Hansen Medical, Inc.	NASDAQ",
"HSOL	Hanwha SolarOne Co., Ltd.	NASDAQ",
"HDNG	Hardinge, Inc.	NASDAQ",
"HLIT	Harmonic Inc.	NASDAQ",
"TINY	Harris & Harris Group, Inc.	NASDAQ",
"HART          	Harvard Apparatus Regenerative Technology, Inc.	NASDAQ",
"HBIO	Harvard Bioscience, Inc.	NASDAQ",
"HCAP	Harvest Capital Credit Corporation	NASDAQ",
"HAS	Hasbro, Inc.	NASDAQ",
"HAST	Hastings Entertainment, Inc.	NASDAQ",
"HA	Hawaiian Holdings, Inc.	NASDAQ",
"HCOM	Hawaiian Telcom Holdco, Inc.	NASDAQ",
"HWKN	Hawkins, Inc.	NASDAQ",
"HWBK	Hawthorn Bancshares, Inc.	NASDAQ",
"HAYN	Haynes International, Inc.	NASDAQ",
"HDS	HD Supply Holdings, Inc.	NASDAQ",
"HIIQ	Health Insurance Innovations, Inc.	NASDAQ",
"HCSG	Healthcare Services Group, Inc.	NASDAQ",
"HSTM	HealthStream, Inc.	NASDAQ",
"HWAY	Healthways, Inc.	NASDAQ",
"HTLD	Heartland Express, Inc.	NASDAQ",
"HTLF	Heartland Financial USA, Inc.	NASDAQ",
"HTWR	Heartware International, Inc.	NASDAQ",
"HTBX	Heat Biologics, Inc.	NASDAQ",
"HSII	Heidrick & Struggles International, Inc.	NASDAQ",
"HELE	Helen of Troy Limited	NASDAQ",
"HMNY	Helios and Matheson Analytics Inc	NASDAQ",
"HMTV	Hemisphere Media Group, Inc.	NASDAQ",
"HCAC	Hennessy Capital Acquisition Corp.	NASDAQ",
"HCACU	Hennessy Capital Acquisition Corp.	NASDAQ",
"HCACW	Hennessy Capital Acquisition Corp.	NASDAQ",
"HSIC	Henry Schein, Inc.	NASDAQ",
"HERO	Hercules Offshore, Inc.	NASDAQ",
"HTBK	Heritage Commerce Corp	NASDAQ",
"HFWA	Heritage Financial Corporation	NASDAQ",
"HBOS	Heritage Financial Group	NASDAQ",
"HEOP	Heritage Oaks Bancorp	NASDAQ",
"HCCI	Heritage-Crystal Clean, Inc.	NASDAQ",
"MLHR	Herman Miller, Inc.	NASDAQ",
"HRTX	Heron Therapeutics, Inc.  	NASDAQ",
"HSKA	Heska Corporation	NASDAQ",
"HFFC	HF Financial Corp.	NASDAQ",
"HTWO	HF2 Financial Management Inc.	NASDAQ",
"HIBB	Hibbett Sports, Inc.	NASDAQ",
"HTCO	Hickory Tech Corporation	NASDAQ",
"HIHO	Highway Holdings Limited	NASDAQ",
"HIMX	Himax Technologies, Inc.	NASDAQ",
"HIFS	Hingham Institution for Savings	NASDAQ",
"HITK	Hi-Tech Pharmacal Co., Inc.	NASDAQ",
"HITT	Hittite Microwave Corporation	NASDAQ",
"HMNF	HMN Financial, Inc.	NASDAQ",
"HMSY	HMS Holdings Corp	NASDAQ",
"HOLI	Hollysys Automation Technologies, Ltd.	NASDAQ",
"HOLX	Hologic, Inc.	NASDAQ",
"HBCP	Home Bancorp, Inc.	NASDAQ",
"HOMB	Home BancShares, Inc.	NASDAQ",
"HOME	Home Federal Bancorp, Inc.	NASDAQ",
"HFBL	Home Federal Bancorp, Inc. of Louisiana	NASDAQ",
"HMIN	Home Inns & Hotels Management Inc.	NASDAQ",
"HLSS	Home Loan Servicing Solutions, Ltd.	NASDAQ",
"AWAY	HomeAway, Inc.	NASDAQ",
"HMST	HomeStreet, Inc.	NASDAQ",
"HTBI	HomeTrust Bancshares, Inc.	NASDAQ",
"HPJ	Hong Kong Highpower Technology	NASDAQ",
"HKTV	Hong Kong Television Network Limited	NASDAQ",
"HOFT	Hooker Furniture Corporation	NASDAQ",
"HFBC	HopFed Bancorp, Inc.	NASDAQ",
"HBNC	Horizon Bancorp (IN)	NASDAQ",
"HZNP	Horizon Pharma, Inc.	NASDAQ",
"HRZN	Horizon Technology Finance Corporation	NASDAQ",
"ZINC	Horsehead Holding Corp.	NASDAQ",
"HMHC	Houghton Mifflin Harcourt Company	NASDAQ",
"HWCC	Houston Wire & Cable Company	NASDAQ",
"HOVNP	Hovnanian Enterprises Inc	NASDAQ",
"HBMD	Howard Bancorp, Inc.	NASDAQ",
"HSNI	HSN, Inc.	NASDAQ",
"HUBG	Hub Group, Inc.	NASDAQ",
"HCBK	Hudson City Bancorp, Inc.	NASDAQ",
"HSON	Hudson Global, Inc.	NASDAQ",
"HDSN	Hudson Technologies, Inc.	NASDAQ",
"HBAN	Huntington Bancshares Incorporated	NASDAQ",
"HBANP	Huntington Bancshares Incorporated	NASDAQ",
"HURC	Hurco Companies, Inc.	NASDAQ",
"HURN	Huron Consulting Group Inc.	NASDAQ",
"HTCH	Hutchinson Technology Incorporated	NASDAQ",
"HBP	Huttig Building Products, Inc.	NASDAQ",
"HPAC	Hyde Park Acquisition Corp. II	NASDAQ",
"HYGS	Hydrogenics Corporation	NASDAQ",
"HPTX	Hyperion Therapeutics, Inc.	NASDAQ",
"IDSY	I.D. Systems, Inc.	NASDAQ",
"IACI	IAC/InterActiveCorp	NASDAQ",
"IKGH	Iao Kun Group Holding Company Limited	NASDAQ",
"IBKC	IBERIABANK Corporation	NASDAQ",
"ICAD	icad inc.	NASDAQ",
"IEP	Icahn Enterprises L.P.	NASDAQ",
"ICFI	ICF International, Inc.	NASDAQ",
"ICGE	ICG Group, Inc.	NASDAQ",
"ICLR	ICON plc	NASDAQ",
"ICON	Iconix Brand Group, Inc.	NASDAQ",
"ICUI	ICU Medical, Inc.	NASDAQ",
"IPWR	Ideal Power Inc.	NASDAQ",
"IDIX	Idenix Pharmaceuticals, Inc.	NASDAQ",
"INVE	Identive Group, Inc.	NASDAQ",
"IDRA	Idera Pharmaceuticals, Inc.	NASDAQ",
"IDXX	IDEXX Laboratories, Inc.	NASDAQ",
"IROQ	IF Bancorp, Inc.	NASDAQ",
"IGTE	iGATE Corporation	NASDAQ",
"IRG	Ignite Restaurant Group, Inc.	NASDAQ",
"RXDX	Ignyta, Inc.	NASDAQ",
"IIVI	II-VI Incorporated	NASDAQ",
"IKAN	Ikanos Communications, Inc.	NASDAQ",
"IKNX	Ikonics Corporation	NASDAQ",
"ILMN	Illumina, Inc.	NASDAQ",
"ISNS	Image Sensing Systems, Inc.	NASDAQ",
"IMMR	Immersion Corporation	NASDAQ",
"ICCC	ImmuCell Corporation	NASDAQ",
"IMGN	ImmunoGen, Inc.	NASDAQ",
"IMMU	Immunomedics, Inc.	NASDAQ",
"IPXL	Impax Laboratories, Inc.	NASDAQ",
"IMMY	Imprimis Pharmaceuticals, Inc.	NASDAQ",
"IMRS	Imris Inc	NASDAQ",
"SAAS	inContact, Inc.	NASDAQ",
"INCY	Incyte Corporation	NASDAQ",
"INDB	Independent Bank Corp.	NASDAQ",
"IBCP	Independent Bank Corporation	NASDAQ",
"IBTX	Independent Bank Group, Inc	NASDAQ",
"IDSA	Industrial Services of America, Inc.	NASDAQ",
"INFN	Infinera Corporation	NASDAQ",
"INXB	Infinity Cross Border Acquisition Corporation	NASDAQ",
"INXBU	Infinity Cross Border Acquisition Corporation	NASDAQ",
"INXBW	Infinity Cross Border Acquisition Corporation	NASDAQ",
"INFI	Infinity Pharmaceuticals, Inc.	NASDAQ",
"IPCC	Infinity Property and Casualty Corporation	NASDAQ",
"INFA	Informatica Corporation	NASDAQ",
"III	Information Services Group, Inc.	NASDAQ",
"IFON	InfoSonics Corp	NASDAQ",
"IMKTA	Ingles Markets, Incorporated	NASDAQ",
"INWK	InnerWorkings, Inc.	NASDAQ",
"INOD	Innodata Inc.	NASDAQ",
"IPHS	Innophos Holdings, Inc.	NASDAQ",
"IOSP	Innospec Inc.	NASDAQ",
"ISSC	Innovative Solutions and Support, Inc.	NASDAQ",
"INGN	Inogen, Inc	NASDAQ",
"NSIT	Insight Enterprises, Inc.	NASDAQ",
"ISIG	Insignia Systems, Inc.	NASDAQ",
"INSM	Insmed, Inc.	NASDAQ",
"IIIN	Insteel Industries, Inc.	NASDAQ",
"PODD	Insulet Corporation	NASDAQ",
"INSY	Insys Therapeutics, Inc.	NASDAQ",
"IART	Integra LifeSciences Holdings Corporation	NASDAQ",
"IDTI	Integrated Device Technology, Inc.	NASDAQ",
"IESC	Integrated Electrical Services, Inc.	NASDAQ",
"ISSI	Integrated Silicon Solution, Inc.	NASDAQ",
"INTC	Intel Corporation	NASDAQ",
"IQNT	Inteliquent, Inc.	NASDAQ",
"IPCI	Intellipharmaceutics International Inc.	NASDAQ",
"IPAR	Inter Parfums, Inc.	NASDAQ",
"IBKR	Interactive Brokers Group, Inc.	NASDAQ",
"ININ	Interactive Intelligence Group, Inc.	NASDAQ",
"ICPT	Intercept Pharmaceuticals, Inc.	NASDAQ",
"ICLD	InterCloud Systems, Inc	NASDAQ",
"ICLDW	InterCloud Systems, Inc	NASDAQ",
"IDCC	InterDigital, Inc.	NASDAQ",
"TILE	Interface, Inc.	NASDAQ",
"IMI	Intermolecular, Inc.	NASDAQ",
"IMCB	Intermountain Community Bancorp	NASDAQ",
"ITMN	InterMune, Inc.	NASDAQ",
"INAP	Internap Network Services Corporation	NASDAQ",
"IBOC	International Bancshares Corporation	NASDAQ",
"ISCA	International Speedway Corporation	NASDAQ",
"IGLD	Internet Gold Golden Lines Ltd.	NASDAQ",
"IIJI	Internet Initiative Japan, Inc.	NASDAQ",
"PTNT	Internet Patents Corporation	NASDAQ",
"INPH	Interphase Corporation	NASDAQ",
"INTX	Intersections, Inc.	NASDAQ",
"ISIL	Intersil Corporation	NASDAQ",
"IILG	Interval Leisure Group, Inc.	NASDAQ",
"IBCA	Intervest Bancshares Corp.	NASDAQ",
"IVAC	Intevac, Inc.	NASDAQ",
"INTL	INTL FCStone Inc.	NASDAQ",
"INTLL	INTL FCStone Inc.	NASDAQ",
"ITCI	Intra-Cellular Therapies Inc.	NASDAQ",
"IIN	IntriCon Corporation	NASDAQ",
"INTU	Intuit Inc.	NASDAQ",
"ISRG	Intuitive Surgical, Inc.	NASDAQ",
"SNAK	Inventure Foods, Inc.	NASDAQ",
"ISBC	Investors Bancorp, Inc.	NASDAQ",
"ITIC	Investors Title Company	NASDAQ",
"IPAS	iPass Inc.	NASDAQ",
"IPCM	IPC The Hospitalist Company, Inc.	NASDAQ",
"IPGP	IPG Photonics Corporation	NASDAQ",
"IRIX	IRIDEX Corporation	NASDAQ",
"IRDM	Iridium Communications Inc	NASDAQ",
"IRDMZ	Iridium Communications Inc	NASDAQ",
"IRBT	iRobot Corporation	NASDAQ",
"IRWD	Ironwood Pharmaceuticals, Inc.	NASDAQ",
"GNMA	iShares Barclays GNMA Bond Fund	NASDAQ",
"FCHI	iShares FTSE China (HK Listed) Index Fund	NASDAQ",
"IFSM	iShares FTSE Developed Small Cap ex-North America Index Fund	NASDAQ",
"IFAS	iShares FTSE EPRA/NAREIT Asia Index Fund	NASDAQ",
"IFEU	iShares FTSE EPRA/NAREIT Europe Index Fund	NASDAQ",
"IFGL	iShares FTSE EPRA/NAREIT Global Real Estate ex-U.S. Index Fund	NASDAQ",
"IFNA	iShares FTSE EPRA/NAREIT North America Index Fund	NASDAQ",
"SOXX	iShares Goldman Sachs Semiconductor Index Fund	NASDAQ",
"ACWX	iShares MSCI ACWI ex US Index Fund	NASDAQ",
"ACWI	iShares MSCI ACWI Index Fund	NASDAQ",
"AAXJ	iShares MSCI All Country Asia ex Japan Index Fund	NASDAQ",
"AXJS	iShares MSCI All Country Asia ex Japan Small Cap Index Fund	NASDAQ",
"AAIT	iShares MSCI All Country Asia Information Technology Index Fun	NASDAQ",
"EEMA	iShares MSCI Emerging Markets Asia Index Fund	NASDAQ",
"EMDI	iShares MSCI Emerging Markets Consumer Discrectionary Sector I	NASDAQ",
"EEME	iShares MSCI Emerging Markets EMEA Index Fund	NASDAQ",
"EMEY	iShares MSCI Emerging Markets Energy Sector Capped Index Fund	NASDAQ",
"EMFN	iShares MSCI Emerging Markets Financials Sector Index Fund	NASDAQ",
"EGRW	iShares MSCI Emerging Markets Growth Index Fund	NASDAQ",
"EEML	iShares MSCI Emerging Markets Latin America Index Fund	NASDAQ",
"EMMT	iShares MSCI Emerging Markets Materials Sector Index Fund	NASDAQ",
"EVAL	iShares MSCI Emerging Markets Value Index Fund	NASDAQ",
"EUFN	iShares MSCI Europe Financials Sector Index Fund	NASDAQ",
"FEFN	iShares MSCI Far East Financials Sector Index Fund	NASDAQ",
"IBB	iShares NASDAQ Biotechnology Index Fund	NASDAQ",
"EMIF	iShares S&P Emerging Markets Infrastructure Index Fund	NASDAQ",
"ICLN	iShares S&P Global Clean Energy Index Fund	NASDAQ",
"NUCL	iShares S&P Global Nuclear Index Fund	NASDAQ",
"WOOD	iShares S&P Global Timber &Forestry Index Fund	NASDAQ",
"INDY	iShares S&P India Nifty 50 Index Fund	NASDAQ",
"ISHG	iShares S&P/Citigroup 1-3 Year International Treasury Bond Fun	NASDAQ",
"IGOV	iShares S&P/Citigroup International Treasury Bond Fund	NASDAQ",
"ISIS	Isis Pharmaceuticals, Inc.	NASDAQ",
"ISLE	Isle of Capri Casinos, Inc.	NASDAQ",
"ISRL	Isramco, Inc.	NASDAQ",
"ITRI	Itron, Inc.	NASDAQ",
"ITRN	Ituran Location and Control Ltd.	NASDAQ",
"IVAN	Ivanhoe Energy, Inc.	NASDAQ",
"XXIA	Ixia	NASDAQ",
"IXYS	IXYS Corporation	NASDAQ",
"JJSF	J & J Snack Foods Corp.	NASDAQ",
"MAYS	J. W. Mays, Inc.	NASDAQ",
"JBHT	J.B. Hunt Transport Services, Inc.	NASDAQ",
"JCOM	j2 Global, Inc.	NASDAQ",
"JASO	JA Solar Holdings, Co., Ltd.	NASDAQ",
"JKHY	Jack Henry & Associates, Inc.	NASDAQ",
"JACK	Jack In The Box Inc.	NASDAQ",
"JXSB	Jacksonville Bancorp Inc.	NASDAQ",
"JAXB	Jacksonville Bancorp, Inc.	NASDAQ",
"JAKK	JAKKS Pacific, Inc.	NASDAQ",
"JMBA	Jamba, Inc.	NASDAQ",
"JRCC	James River Coal Company	NASDAQ",
"JAZZ	Jazz Pharmaceuticals plc	NASDAQ",
"JDSU	JDS Uniphase Corporation	NASDAQ",
"JFBI	Jefferson Bancshares, Inc.	NASDAQ",
"JBLU	JetBlue Airways Corporation	NASDAQ",
"JTPY	JetPay Corporation	NASDAQ",
"JCTCF	Jewett-Cameron Trading Company	NASDAQ",
"DATE	Jiayuan.com International Ltd.	NASDAQ",
"JST	Jinpan International Limited	NASDAQ",
"JIVE	Jive Software, Inc.	NASDAQ",
"JOEZ	Joe&#39;s Jeans Inc.	NASDAQ",
"JBSS	John B. Sanfilippo & Son, Inc.	NASDAQ",
"JOUT	Johnson Outdoors Inc.	NASDAQ",
"JOSB	Jos. A. Bank Clothiers, Inc.	NASDAQ",
"TAX	JTH Holding Inc. D/B/A Liberty Tax Service	NASDAQ",
"KALU	Kaiser Aluminum Corporation	NASDAQ",
"KBIO	KaloBios Pharmaceuticals, Inc.	NASDAQ",
"KMDA	Kamada Ltd.	NASDAQ",
"KNDI	Kandi Technologies Group, Inc.	NASDAQ",
"KCLI	Kansas City Life Insurance Company	NASDAQ",
"KPTI	Karyopharm Therapeutics Inc.	NASDAQ",
"KCAP	KCAP Financial, Inc.	NASDAQ",
"KRNY	Kearny Financial	NASDAQ",
"KIPO	Keating Capital, Inc.	NASDAQ",
"KELYA	Kelly Services, Inc.	NASDAQ",
"KELYB	Kelly Services, Inc.	NASDAQ",
"KFFB	Kentucky First Federal Bancorp	NASDAQ",
"KERX	Keryx Biopharmaceuticals, Inc.	NASDAQ",
"GMCR	Keurig Green Mountain, Inc.	NASDAQ",
"KEQU	Kewaunee Scientific Corporation	NASDAQ",
"KTEC	Key Technology, Inc.	NASDAQ",
"KTCC	Key Tronic Corporation	NASDAQ",
"KFRC	Kforce, Inc.	NASDAQ",
"KBALB	Kimball International, Inc.	NASDAQ",
"KIN	Kindred Biosciences, Inc.	NASDAQ",
"KGJI	Kingold Jewelry Inc.	NASDAQ",
"KINS	Kingstone Companies, Inc	NASDAQ",
"KONE	Kingtone Wirelessinfo Solution Holding Ltd	NASDAQ",
"KIOR	KiOR, Inc.	NASDAQ",
"KIPS	Kips Bay Medical, Inc.	NASDAQ",
"KIRK	Kirkland&#39;s, Inc.	NASDAQ",
"KLAC	KLA-Tencor Corporation	NASDAQ",
"VLCCF	Knightsbridge Tankers Limited	NASDAQ",
"KFX	Kofax Limited	NASDAQ",
"KONA	Kona Grill, Inc.	NASDAQ",
"KONG	KongZhong Corporation	NASDAQ",
"KOPN	Kopin Corporation	NASDAQ",
"KOSS	Koss Corporation	NASDAQ",
"KRFT	Kraft Foods Group, Inc.	NASDAQ",
"KWEB	KraneShares CSI China Internet ETF	NASDAQ",
"KTOS	Kratos Defense & Security Solutions, Inc.	NASDAQ",
"KUTV	Ku6 Media Co., Ltd.	NASDAQ",
"KLIC	Kulicke and Soffa Industries, Inc.	NASDAQ",
"KVHI	KVH Industries, Inc.	NASDAQ",
"KYTH	Kythera Biopharmaceuticals, Inc.	NASDAQ",
"LLEN	L&L Energy, Inc.	NASDAQ",
"FSTR	L.B. Foster Company	NASDAQ",
"LJPC	La Jolla Pharmaceutical Company	NASDAQ",
"LSBK	Lake Shore Bancorp, Inc.	NASDAQ",
"LBAI	Lakeland Bancorp, Inc.	NASDAQ",
"LKFN	Lakeland Financial Corporation	NASDAQ",
"LAKE	Lakeland Industries, Inc.	NASDAQ",
"LACO	Lakes Entertainment, Inc.	NASDAQ",
"LRCX	Lam Research Corporation	NASDAQ",
"LAMR	Lamar Advertising Company	NASDAQ",
"LANC	Lancaster Colony Corporation	NASDAQ",
"LNDC	Landec Corporation	NASDAQ",
"LARK	Landmark Bancorp Inc.	NASDAQ",
"LEDMV	Lands&#39; End, Inc.	NASDAQ",
"LSTR	Landstar System, Inc.	NASDAQ",
"LTRX	Lantronix, Inc.	NASDAQ",
"LPSB	LaPorte Bancorp, Inc.	NASDAQ",
"LSCC	Lattice Semiconductor Corporation	NASDAQ",
"LAWS	Lawson Products, Inc.	NASDAQ",
"LAYN	Layne Christensen Company	NASDAQ",
"LCAV	LCA-Vision Inc.	NASDAQ",
"LCNB	LCNB Corporation	NASDAQ",
"LDRH	LDR Holding Corporation	NASDAQ",
"GAGA	Le Gaga Holdings Limited	NASDAQ",
"LBIX	Leading Brands Inc	NASDAQ",
"LTRE	Learning Tree International, Inc.	NASDAQ",
"LGCY	Legacy Reserves LP	NASDAQ",
"LMAT	LeMaitre Vascular, Inc.	NASDAQ",
"LEVY	Levy Acquisition Corp.	NASDAQ",
"LEVYU	Levy Acquisition Corp.	NASDAQ",
"LEVYW	Levy Acquisition Corp.	NASDAQ",
"LXRX	Lexicon Pharmaceuticals, Inc.	NASDAQ",
"LGIH	LGI Homes, Inc.	NASDAQ",
"LHCG	LHC Group	NASDAQ",
"LBTYA	Liberty Global plc	NASDAQ",
"LBTYB	Liberty Global plc	NASDAQ",
"LBTYK	Liberty Global plc	NASDAQ",
"LINTA	Liberty Interactive Corporation	NASDAQ",
"LINTB	Liberty Interactive Corporation	NASDAQ",
"LVNTA	Liberty Interactive Corporation	NASDAQ",
"LVNTB	Liberty Interactive Corporation	NASDAQ",
"LMCA	Liberty Media Corporation	NASDAQ",
"LMCB	Liberty Media Corporation	NASDAQ",
"LPHI	Life Partners Holdings Inc	NASDAQ",
"LPNT	LifePoint Hospitals, Inc.	NASDAQ",
"LCUT	Lifetime Brands, Inc.	NASDAQ",
"LFVN	Lifevantage Corporation	NASDAQ",
"LWAY	Lifeway Foods, Inc.	NASDAQ",
"LGND	Ligand Pharmaceuticals Incorporated	NASDAQ",
"LTBR	Lightbridge Corporation	NASDAQ",
"LPTH	LightPath Technologies, Inc.	NASDAQ",
"LIWA	Lihua International, Inc.	NASDAQ",
"LLEX	Lilis Energy, Inc.	NASDAQ",
"LIME	Lime Energy Co.	NASDAQ",
"LLNW	Limelight Networks, Inc.	NASDAQ",
"LMNR	Limoneira Co	NASDAQ",
"LINC	Lincoln Educational Services Corporation	NASDAQ",
"LECO	Lincoln Electric Holdings, Inc.	NASDAQ",
"LLTC	Linear Technology Corporation	NASDAQ",
"LNCO	Linn Co, LLC	NASDAQ",
"LINE	Linn Energy, LLC	NASDAQ",
"LIOX	Lionbridge Technologies, Inc.	NASDAQ",
"LPCN	Lipocine Inc.	NASDAQ",
"LPDX	LipoScience, Inc.	NASDAQ",
"LIQD	Liquid Holdings Group, Inc.	NASDAQ",
"LQDT	Liquidity Services, Inc.	NASDAQ",
"LFUS	Littelfuse, Inc.	NASDAQ",
"LIVE	LiveDeal, Inc.	NASDAQ",
"LPSN	LivePerson, Inc.	NASDAQ",
"LKQ	LKQ Corporation	NASDAQ",
"LMIA	LMI Aerospace, Inc.	NASDAQ",
"LNBB	LNB Bancorp, Inc.	NASDAQ",
"LOCM	Local Corporation	NASDAQ",
"LOGI	Logitech International S.A.	NASDAQ",
"LOGM	LogMein, Inc.	NASDAQ",
"LOJN	LoJack Corporation	NASDAQ",
"LOOK	LookSmart, Ltd.	NASDAQ",
"LORL	Loral Space and Communications, Inc.	NASDAQ",
"LABC	Louisiana Bancorp, Inc.	NASDAQ",
"LPTN	Lpath, Inc.	NASDAQ",
"LPLA	LPL Financial Holdings Inc.	NASDAQ",
"LRAD	LRAD Corporation	NASDAQ",
"LSBI	LSB Financial Corp.	NASDAQ",
"LSI	LSI Corporation	NASDAQ",
"LYTS	LSI Industries Inc.	NASDAQ",
"LTXC	LTX-Credence Corporation	NASDAQ",
"LULU	lululemon athletica inc.	NASDAQ",
"LMNS	Lumenis Ltd.	NASDAQ",
"LMNX	Luminex Corporation	NASDAQ",
"LMOS	Lumos Networks Corp.	NASDAQ",
"LUNA	Luna Innovations Incorporated	NASDAQ",
"MBTF	M B T Financial Corp	NASDAQ",
"MTSI	M/A-COM Technology Solutions Holdings, Inc.	NASDAQ",
"MCBC	Macatawa Bank Corporation	NASDAQ",
"MFNC	Mackinac Financial Corporation	NASDAQ",
"MGNX	MacroGenics, Inc.	NASDAQ",
"MCBK	Madison County Financial, Inc.	NASDAQ",
"MAGS	Magal Security Systems Ltd.	NASDAQ",
"MGLN	Magellan Health Services, Inc.	NASDAQ",
"MPET	Magellan Petroleum Corporation	NASDAQ",
"MGIC	Magic Software Enterprises Ltd.	NASDAQ",
"CALL	magicJack VocalTec Ltd	NASDAQ",
"MNGA	MagneGas Corporation	NASDAQ",
"MAG	Magnetek, Inc.	NASDAQ",
"MGYR	Magyar Bancorp, Inc.	NASDAQ",
"MHLD	Maiden Holdings, Ltd.	NASDAQ",
"MHLDO	Maiden Holdings, Ltd.	NASDAQ",
"MSFG	MainSource Financial Group, Inc.	NASDAQ",
"COOL	Majesco Entertainment Company	NASDAQ",
"MMYT	MakeMyTrip Limited	NASDAQ",
"MBUU	Malibu Boats, Inc.	NASDAQ",
"MLVF	Malvern Bancorp, Inc.	NASDAQ",
"MAMS	MAM Software Group, Inc.	NASDAQ",
"MNDL	Mandalay Digital Group, Inc	NASDAQ",
"MANH	Manhattan Associates, Inc.	NASDAQ",
"LOAN	Manhattan Bridge Capital, Inc	NASDAQ",
"MNTX	Manitex International, Inc.	NASDAQ",
"MTEX	Mannatech, Incorporated	NASDAQ",
"MNKD	MannKind Corporation	NASDAQ",
"MANT	ManTech International Corporation	NASDAQ",
"MCHX	Marchex, Inc.	NASDAQ",
"MARPS	Marine Petroleum Trust	NASDAQ",
"MKTX	MarketAxess Holdings, Inc.	NASDAQ",
"MKTO	Marketo, Inc.	NASDAQ",
"MRLN	Marlin Business Services Corp.	NASDAQ",
"FISH	Marlin Midstream Partners, LP	NASDAQ",
"MAR	Marriott International	NASDAQ",
"MBII	Marrone Bio Innovations, Inc.	NASDAQ",
"MRTN	Marten Transport, Ltd.	NASDAQ",
"MMLP	Martin Midstream Partners L.P.	NASDAQ",
"MRVL	Marvell Technology Group Ltd.	NASDAQ",
"MASI	Masimo Corporation	NASDAQ",
"MTRX	Matrix Service Company	NASDAQ",
"MAT	Mattel, Inc.	NASDAQ",
"MATR	Mattersight Corporation	NASDAQ",
"MATW	Matthews International Corporation	NASDAQ",
"MFRM	Mattress Firm Holding Corp.	NASDAQ",
"MTSN	Mattson Technology, Inc.	NASDAQ",
"MXIM	Maxim Integrated Products, Inc.	NASDAQ",
"MXWL	Maxwell Technologies, Inc.	NASDAQ",
"MZOR	Mazor Robotics Ltd.	NASDAQ",
"MBFI	MB Financial Inc.	NASDAQ",
"MCGC	MCG Capital Corporation	NASDAQ",
"MGRC	McGrath RentCorp	NASDAQ",
"MDCA	MDC Partners Inc.	NASDAQ",
"MEAS	Measurement Specialties, Inc.	NASDAQ",
"MCOX	Mecox Lane Limited	NASDAQ",
"TAXI	Medallion Financial Corp.	NASDAQ",
"MDAS	MedAssets, Inc.	NASDAQ",
"MBIS	Mediabistro Inc.	NASDAQ",
"MDCI	Medical Action Industries Inc.	NASDAQ",
"MNOV	MediciNova, Inc.	NASDAQ",
"MDSO	Medidata Solutions, Inc.	NASDAQ",
"MDVN	Medivation, Inc.	NASDAQ",
"MDWD	MediWound Ltd.	NASDAQ",
"MEIP	MEI Pharma, Inc.	NASDAQ",
"MELA	MELA Sciences, Inc	NASDAQ",
"MPEL	Melco Crown Entertainment Limited	NASDAQ",
"MLNX	Mellanox Technologies, Ltd.	NASDAQ",
"MEMP	Memorial Production Partners LP	NASDAQ",
"MENT	Mentor Graphics Corporation	NASDAQ",
"MTSL	MER Telemanagement Solutions Ltd.	NASDAQ",
"MELI	MercadoLibre, Inc.	NASDAQ",
"MBWM	Mercantile Bank Corporation	NASDAQ",
"MERC	Mercer International Inc.	NASDAQ",
"MBVT	Merchants Bancshares, Inc.	NASDAQ",
"MRCY	Mercury Systems Inc	NASDAQ",
"MRGE	Merge Healthcare Incorporated.	NASDAQ",
"MWRX	MergeWorthRx Corp.	NASDAQ",
"VIVO	Meridian Bioscience Inc.	NASDAQ",
"EBSB	Meridian Interstate Bancorp, Inc.	NASDAQ",
"MMSI	Merit Medical Systems, Inc.	NASDAQ",
"MACK	Merrimack Pharmaceuticals, Inc.	NASDAQ",
"MERU	Meru Networks, Inc.	NASDAQ",
"MSLI	Merus Labs International Inc.	NASDAQ",
"MLAB	Mesa Laboratories, Inc.	NASDAQ",
"CASH	Meta Financial Group, Inc.	NASDAQ",
"MBLX	Metabolix, Inc.	NASDAQ",
"MEOH	Methanex Corporation	NASDAQ",
"MEIL	METHES ENERGIES INTERNATIONAL LTD	NASDAQ",
"MEILW	METHES ENERGIES INTERNATIONAL LTD	NASDAQ",
"MEILZ	METHES ENERGIES INTERNATIONAL LTD	NASDAQ",
"METR	Metro Bancorp, Inc	NASDAQ",
"MFRI	MFRI, Inc.	NASDAQ",
"MGCD	MGC Diagnostics Corporation	NASDAQ",
"MGEE	MGE Energy Inc.	NASDAQ",
"MGPI	MGP Ingredients, Inc.	NASDAQ",
"MCRL	Micrel, Incorporated	NASDAQ",
"MCHP	Microchip Technology Incorporated	NASDAQ",
"MFI	MicroFinancial Incorporated	NASDAQ",
"MU	Micron Technology, Inc.	NASDAQ",
"MICT	Micronet Enertec Technologies, Inc.	NASDAQ",
"MICTW	Micronet Enertec Technologies, Inc.	NASDAQ",
"MCRS	MICROS Systems, Inc.	NASDAQ",
"MSCC	Microsemi Corporation	NASDAQ",
"MSFT	Microsoft Corporation	NASDAQ",
"MSTR	MicroStrategy Incorporated	NASDAQ",
"MVIS	Microvision, Inc.	NASDAQ",
"MPB	Mid Penn Bancorp	NASDAQ",
"MCEP	Mid-Con Energy Partners, LP	NASDAQ",
"MBRG	Middleburg Financial Corporation	NASDAQ",
"MSEX	Middlesex Water Company	NASDAQ",
"MOFG	MidWestOne Financial Group, Inc.	NASDAQ",
"MDXG	MiMedx Group, Inc	NASDAQ",
"MNDO	MIND C.T.I. Ltd.	NASDAQ",
"MRTX	Mirati Therapeutics, Inc.	NASDAQ",
"MSON	MISONIX, Inc.	NASDAQ",
"MIND	Mitcham Industries, Inc.	NASDAQ",
"MITK	Mitek Systems, Inc.	NASDAQ",
"MITL	Mitel Networks Corporation	NASDAQ",
"MKSI	MKS Instruments, Inc.	NASDAQ",
"MINI	Mobile Mini, Inc.	NASDAQ",
"MOCO	MOCON, Inc.	NASDAQ",
"MLNK	ModusLink Global Solutions, Inc	NASDAQ",
"MNTA	Momenta Pharmaceuticals, Inc.	NASDAQ",
"MCRI	Monarch Casino & Resort, Inc.	NASDAQ",
"MNRK	Monarch Financial Holdings, Inc.	NASDAQ",
"MDLZ	Mondelez International, Inc.	NASDAQ",
"MGI	Moneygram International, Inc.	NASDAQ",
"MPWR	Monolithic Power Systems, Inc.	NASDAQ",
"TYPE	Monotype Imaging Holdings Inc.	NASDAQ",
"MNRO	Monro Muffler Brake, Inc.	NASDAQ",
"MRCC	Monroe Capital Corporation	NASDAQ",
"MNST	Monster Beverage Corporation	NASDAQ",
"MONT	Montage Technology Group Limited	NASDAQ",
"MHGC	Morgans Hotel Group Co.	NASDAQ",
"MORN	Morningstar, Inc.	NASDAQ",
"MOSY	MoSys, Inc.	NASDAQ",
"MPAA	Motorcar Parts of America, Inc.	NASDAQ",
"MOVE	Move, Inc.	NASDAQ",
"MRVC	MRV Communications, Inc.	NASDAQ",
"MSBF	MSB Financial Corp.	NASDAQ",
"MNTG	MTR Gaming Group, Inc.	NASDAQ",
"MTSC	MTS Systems Corporation	NASDAQ",
"LABL	Multi-Color Corporation	NASDAQ",
"MFLX	Multi-Fineline Electronix, Inc.	NASDAQ",
"MGAM	Multimedia Games Holding Company, Inc.	NASDAQ",
"MFSF	MutualFirst Financial Inc.	NASDAQ",
"MWIV	MWI Veterinary Supply, Inc.	NASDAQ",
"MYL	Mylan Inc.	NASDAQ",
"MYRG	MYR Group, Inc.	NASDAQ",
"MYGN	Myriad Genetics, Inc.	NASDAQ",
"NANO	Nanometrics Incorporated	NASDAQ",
"NSPH	Nanosphere, Inc.	NASDAQ",
"NSTG	NanoString Technologies, Inc.	NASDAQ",
"NSSC	NAPCO Security Technologies, Inc.	NASDAQ",
"NASB	NASB Financial Inc.	NASDAQ",
"QQQX	NASDAQ Premium Income and Growth Fund Inc.	NASDAQ",
"NATH	Nathan&#39;s Famous, Inc.	NASDAQ",
"NAUH	National American University Holdings, Inc.	NASDAQ",
"NKSH	National Bankshares, Inc.	NASDAQ",
"FIZZ	National Beverage Corp.	NASDAQ",
"NCMI	National CineMedia, Inc.	NASDAQ",
"NGHC	National General Holdings Corp	NASDAQ",
"NATI	National Instruments Corporation	NASDAQ",
"NATL	National Interstate Corporation	NASDAQ",
"NPBC	National Penn Bancshares, Inc.	NASDAQ",
"NRCIA	National Research Corporation	NASDAQ",
"NRCIB	National Research Corporation	NASDAQ",
"NSEC	National Security Group, Inc.	NASDAQ",
"NWLI	National Western Life Insurance Company	NASDAQ",
"NAII	Natural Alternatives International, Inc.	NASDAQ",
"NATR	Nature&#39;s Sunshine Products, Inc.	NASDAQ",
"BABY	Natus Medical Incorporated	NASDAQ",
"NVSL	Naugatuck Valley Financial Corporation	NASDAQ",
"NBTF	NB&T FINANCIAL GROUP INC	NASDAQ",
"NBTB	NBT Bancorp Inc.	NASDAQ",
"NCIT	NCI, Inc.	NASDAQ",
"NKTR	Nektar Therapeutics	NASDAQ",
"NEOG	Neogen Corporation	NASDAQ",
"NEO	NeoGenomics, Inc.	NASDAQ",
"NEON	Neonode Inc.	NASDAQ",
"NBS	Neostem, Inc.	NASDAQ",
"NRX	NephroGenex, Inc.	NASDAQ",
"NEPT	Neptune Technologies & Bioresources Inc	NASDAQ",
"UEPS	Net 1 UEPS Technologies, Inc.	NASDAQ",
"NETE	Net Element, Inc.	NASDAQ",
"NTAP	NetApp, Inc.	NASDAQ",
"NTES	NetEase, Inc.	NASDAQ",
"NFLX	Netflix, Inc.	NASDAQ",
"NTGR	NETGEAR, Inc.	NASDAQ",
"NLST	Netlist, Inc.	NASDAQ",
"NTCT	NetScout Systems, Inc.	NASDAQ",
"NTWK	NetSol Technologies Inc.	NASDAQ",
"NBIX	Neurocrine Biosciences, Inc.	NASDAQ",
"NURO	NeuroMetrix, Inc.	NASDAQ",
"NCBC	New Century Bancorp, Inc. (NC)	NASDAQ",
"NHTB	New Hampshire Thrift Bancshares, Inc.	NASDAQ",
"NYMT	New York Mortgage Trust, Inc.	NASDAQ",
"NYMTP	New York Mortgage Trust, Inc.	NASDAQ",
"NBBC	NewBridge Bancorp	NASDAQ",
"NEWL	NewLead Holdings Ltd.	NASDAQ",
"NLNK	NewLink Genetics Corporation	NASDAQ",
"NEWP	Newport Corporation	NASDAQ",
"NWS	News Corporation	NASDAQ",
"NWSA	News Corporation	NASDAQ",
"NEWS	NewStar Financial, Inc.	NASDAQ",
"NEWT	Newtek Business Services Inc.	NASDAQ",
"NXST	Nexstar Broadcasting Group, Inc.	NASDAQ",
"NFEC	NF Energy Saving Corporation	NASDAQ",
"NGPC	NGP Capital Resources Company	NASDAQ",
"EGOV	NIC Inc.	NASDAQ",
"NICE	NICE-Systems Limited	NASDAQ",
"NICK	Nicholas Financial, Inc.	NASDAQ",
"NIHD	NII Holdings, Inc.	NASDAQ",
"NINE	Ninetowns Internet Technology Group Company Limited	NASDAQ",
"NMIH	NMI Holdings Inc	NASDAQ",
"NNBR	NN, Inc.	NASDAQ",
"NDLS	Noodles & Company	NASDAQ",
"NDSN	Nordson Corporation	NASDAQ",
"NSYS	Nortech Systems Incorporated	NASDAQ",
"NTK	Nortek Inc.	NASDAQ",
"NOVB	North Valley Bancorp	NASDAQ",
"NBN	Northeast Bancorp	NASDAQ",
"NECB	Northeast Community Bancorp, Inc.	NASDAQ",
"NTIC	Northern Technologies International Corporation	NASDAQ",
"NTRS	Northern Trust Corporation	NASDAQ",
"NFBK	Northfield Bancorp, Inc.	NASDAQ",
"NRIM	Northrim BanCorp Inc	NASDAQ",
"NWBI	Northwest Bancshares, Inc.	NASDAQ",
"NWBO	Northwest Biotherapeutics, Inc.	NASDAQ",
"NWBOW	Northwest Biotherapeutics, Inc.	NASDAQ",
"NWPX	Northwest Pipe Company	NASDAQ",
"NCLH	Norwegian Cruise Line Holdings Ltd.	NASDAQ",
"NWFL	Norwood Financial Corp.	NASDAQ",
"NVFY	Nova Lifestyle, Inc	NASDAQ",
"NVMI	Nova Measuring Instruments Ltd.	NASDAQ",
"NVDQ	Novadaq Technologies Inc	NASDAQ",
"NVTL	Novatel Wireless, Inc.	NASDAQ",
"NVAX	Novavax, Inc.	NASDAQ",
"NVGN	Novogen Limited	NASDAQ",
"NPSP	NPS Pharmaceuticals, Inc.	NASDAQ",
"NTLS	NTELOS Holdings Corp.	NASDAQ",
"NUAN	Nuance Communications, Inc.	NASDAQ",
"NMRX	Numerex Corp.	NASDAQ",
"NUTR	Nutraceutical International Corporation	NASDAQ",
"NTRI	NutriSystem Inc	NASDAQ",
"NUVA	NuVasive, Inc.	NASDAQ",
"NVEE	NV5 Holdings, Inc.	NASDAQ",
"NVEEW	NV5 Holdings, Inc.	NASDAQ",
"NVEC	NVE Corporation	NASDAQ",
"NVDA	NVIDIA Corporation	NASDAQ",
"NXPI	NXP Semiconductors N.V.	NASDAQ",
"NXTM	NxStage Medical, Inc.	NASDAQ",
"NYMX	Nymox Pharmaceutical Corporation	NASDAQ",
"OIIM	O2Micro International Limited	NASDAQ",
"OVLY	Oak Valley Bancorp (CA)	NASDAQ",
"OBAF	OBA Financial Services, Inc.	NASDAQ",
"OBCI	Ocean Bio-Chem, Inc.	NASDAQ",
"OPTT	Ocean Power Technologies, Inc.	NASDAQ",
"ORIG	Ocean Rig UDW Inc.	NASDAQ",
"OSHC	Ocean Shore Holding Co.	NASDAQ",
"OCFC	OceanFirst Financial Corp.	NASDAQ",
"OCRX	Ocera Therapeutics, Inc.	NASDAQ",
"OCLR	Oclaro, Inc.	NASDAQ",
"OFED	Oconee Federal Financial Corp.	NASDAQ",
"OCLS	Oculus Innovative Sciences, Inc.	NASDAQ",
"OMEX	Odyssey Marine Exploration, Inc.	NASDAQ",
"OFS	OFS Capital Corporation	NASDAQ",
"OVBC	Ohio Valley Banc Corp.	NASDAQ",
"OHRP	Ohr Pharmaceuticals, Inc.	NASDAQ",
"ODFL	Old Dominion Freight Line, Inc.	NASDAQ",
"OLBK	Old Line Bancshares, Inc.	NASDAQ",
"ONB	Old National Bancorp	NASDAQ",
"OPOF	Old Point Financial Corporation	NASDAQ",
"OSBC	Old Second Bancorp, Inc.	NASDAQ",
"OSBCP	Old Second Bancorp, Inc.	NASDAQ",
"ZEUS	Olympic Steel, Inc.	NASDAQ",
"OFLX	Omega Flex, Inc.	NASDAQ",
"OMER	Omeros Corporation	NASDAQ",
"OABC	OmniAmerican Bancorp, Inc.	NASDAQ",
"OMCL	Omnicell, Inc.	NASDAQ",
"OVTI	OmniVision Technologies, Inc.	NASDAQ",
"ONNN	ON Semiconductor Corporation	NASDAQ",
"OTIV	On Track Innovations Ltd	NASDAQ",
"OGXI	OncoGenex Pharmaceuticals Inc.	NASDAQ",
"ONCY	Oncolytics Biotech, Inc.	NASDAQ",
"OMED	OncoMed Pharmaceuticals, Inc.	NASDAQ",
"ONTX	Onconova Therapeutics, Inc.	NASDAQ",
"ONTY	Oncothyreon Inc.	NASDAQ",
"ONFC	Oneida Financial Corp.	NASDAQ",
"ONVI	Onvia, Inc.	NASDAQ",
"OTEX	Open Text Corporation	NASDAQ",
"OPEN	OpenTable, Inc.	NASDAQ",
"OPXA	Opexa Therapeutics, Inc.	NASDAQ",
"OPHT	Ophthotech Corporation	NASDAQ",
"OPLK	Oplink Communications, Inc.	NASDAQ",
"OBAS	Optibase Ltd.	NASDAQ",
"OCC	Optical Cable Corporation	NASDAQ",
"OPHC	OptimumBank Holdings, Inc.	NASDAQ",
"ORMP	Oramed Pharmaceuticals Inc.	NASDAQ",
"OSUR	OraSure Technologies, Inc.	NASDAQ",
"ORBC	ORBCOMM Inc.	NASDAQ",
"ORBT	Orbit International Corporation	NASDAQ",
"ORBK	Orbotech Ltd.	NASDAQ",
"ORLY	O&#39;Reilly Automotive, Inc.	NASDAQ",
"OREX	Orexigen Therapeutics, Inc.	NASDAQ",
"SEED	Origin Agritech Limited	NASDAQ",
"ORIT	Oritani Financial Corp.	NASDAQ",
"ORRF	Orrstown Financial Services Inc	NASDAQ",
"OFIX	Orthofix International N.V.	NASDAQ",
"OSIS	OSI Systems, Inc.	NASDAQ",
"OSIR	Osiris Therapeutics, Inc.	NASDAQ",
"OSN	Ossen Innovation Co., Ltd.	NASDAQ",
"OTEL	Otelco Inc.	NASDAQ",
"OTTR	Otter Tail Corporation	NASDAQ",
"OUTR	Outerwall Inc.	NASDAQ",
"OVAS	Ovascience Inc.	NASDAQ",
"OVRL	Overland Storage, Inc.	NASDAQ",
"OSTK	Overstock.com, Inc.	NASDAQ",
"OXBRU	Oxbridge Re Holdings Limited	NASDAQ",
"OXFD	Oxford Immunotec Global PLC	NASDAQ",
"OXLC	Oxford Lane Capital Corp.	NASDAQ",
"OXLCO	Oxford Lane Capital Corp.	NASDAQ",
"OXLCP	Oxford Lane Capital Corp.	NASDAQ",
"OXGN	OXiGENE, Inc.	NASDAQ",
"OXBT	Oxygen Biotherapeutics, Inc.	NASDAQ",
"PFIN	P & F Industries, Inc.	NASDAQ",
"PTSI	P.A.M. Transportation Services, Inc.	NASDAQ",
"PCAR	PACCAR Inc.	NASDAQ",
"PACB	Pacific Biosciences of California, Inc.	NASDAQ",
"PCBK	Pacific Continental Corporation (Ore)	NASDAQ",
"PEIX	Pacific Ethanol, Inc.	NASDAQ",
"PMBC	Pacific Mercantile Bancorp	NASDAQ",
"PPBI	Pacific Premier Bancorp Inc	NASDAQ",
"PSUN	Pacific Sunwear of California, Inc.	NASDAQ",
"PCRX	Pacira Pharmaceuticals, Inc.	NASDAQ",
"PACW	PacWest Bancorp	NASDAQ",
"PTIE	Pain Therapeutics	NASDAQ",
"PLMT	Palmetto Bancshares, Inc. (SC)	NASDAQ",
"PAAS	Pan American Silver Corp.	NASDAQ",
"PNRA	Panera Bread Company	NASDAQ",
"PZZA	Papa John&#39;S International, Inc.	NASDAQ",
"PRGN	Paragon Shipping Inc.	NASDAQ",
"PAMT	Parametric Sound Corp.	NASDAQ",
"PRXL	PAREXEL International Corporation	NASDAQ",
"PCYG	Park City Group, Inc.	NASDAQ",
"PSTB	Park Sterling Corporation	NASDAQ",
"PKBK	Parke Bancorp, Inc.	NASDAQ",
"PRKR	ParkerVision, Inc.	NASDAQ",
"PKOH	Park-Ohio Holdings Corp.	NASDAQ",
"PTNR	Partner Communications Company Ltd.	NASDAQ",
"PBHC	Pathfinder Bancorp, Inc.	NASDAQ",
"PATK	Patrick Industries, Inc.	NASDAQ",
"PNBK	Patriot National Bancorp Inc.	NASDAQ",
"PATR	Patriot Transportation Holding, Inc.	NASDAQ",
"PEGI	Pattern Energy Group Inc.	NASDAQ",
"PDCO	Patterson Companies, Inc.	NASDAQ",
"PTEN	Patterson-UTI Energy, Inc.	NASDAQ",
"PLCC	Paulson Capital (Delaware) Corp.	NASDAQ",
"PAYX	Paychex, Inc.	NASDAQ",
"PCTY	Paylocity Holding Corporation	NASDAQ",
"PCCC	PC Connection, Inc.	NASDAQ",
"PCMI	PCM, Inc.	NASDAQ",
"PCTI	PC-Tel, Inc.	NASDAQ",
"PDCE	PDC Energy, Inc.	NASDAQ",
"PDFS	PDF Solutions, Inc.	NASDAQ",
"PDII	PDI, Inc.	NASDAQ",
"PDLI	PDL BioPharma, Inc.	NASDAQ",
"PGC	Peapack-Gladstone Financial Corporation	NASDAQ",
"PRLS	Peerless Systems Corporation	NASDAQ",
"PEGA	Pegasystems Inc.	NASDAQ",
"PCO	Pendrell Corporation	NASDAQ",
"PENX	Penford Corporation	NASDAQ",
"PENN	Penn National Gaming, Inc.	NASDAQ",
"PFLT	PennantPark Floating Rate Capital Ltd.	NASDAQ",
"PNNT	PennantPark Investment Corporation	NASDAQ",
"PWOD	Penns Woods Bancorp, Inc.	NASDAQ",
"PEBO	Peoples Bancorp Inc.	NASDAQ",
"PEBK	Peoples Bancorp of North Carolina, Inc.	NASDAQ",
"PEOP	Peoples Federal Bancshares, Inc.	NASDAQ",
"PFBX	Peoples Financial Corporation	NASDAQ",
"PFIS	Peoples Financial Services Corporation	NASDAQ",
"PBCT	People&#39;s United Financial, Inc.	NASDAQ",
"PRCP	Perceptron, Inc.	NASDAQ",
"PPHM	Peregrine Pharmaceuticals Inc.	NASDAQ",
"PPHMP	Peregrine Pharmaceuticals Inc.	NASDAQ",
"PSMI	Peregrine Semiconductor Corp.	NASDAQ",
"PWRD	Perfect World Co., Ltd.	NASDAQ",
"PRFT	Perficient, Inc.	NASDAQ",
"PFMT	Performant Financial Corporation	NASDAQ",
"PERF	Perfumania Holdings, Inc	NASDAQ",
"PSEM	Pericom Semiconductor Corporation	NASDAQ",
"PERI	Perion Network Ltd	NASDAQ",
"PESI	Perma-Fix Environmental Services, Inc.	NASDAQ",
"PTX	Pernix Therapeutics Holdings, Inc.	NASDAQ",
"PERY	Perry Ellis International Inc.	NASDAQ",
"PETS	PetMed Express, Inc.	NASDAQ",
"PETM	PetSmart, Inc	NASDAQ",
"PFSW	PFSweb, Inc.	NASDAQ",
"PGTI	PGT, Inc.	NASDAQ",
"PCYC	Pharmacyclics, Inc.	NASDAQ",
"PHII	PHI, Inc.	NASDAQ",
"PHIIK	PHI, Inc.	NASDAQ",
"PHMD	PhotoMedex, Inc.	NASDAQ",
"PLAB	Photronics, Inc.	NASDAQ",
"PICO	PICO Holdings Inc.	NASDAQ",
"PPC	Pilgrim&#39;s Pride Corporation	NASDAQ",
"PME	Pingtan Marine Enterprise Ltd.	NASDAQ",
"PNFP	Pinnacle Financial Partners, Inc.	NASDAQ",
"PPSI	Pioneer Power Solutions, Inc.	NASDAQ",
"PXLW	Pixelworks, Inc.	NASDAQ",
"PZZI	Pizza Inn Holdings, Inc.	NASDAQ",
"PLNR	Planar Systems, Inc.	NASDAQ",
"PLPM	Planet Payment, Inc.	NASDAQ",
"PLXS	Plexus Corp.	NASDAQ",
"PLUG	Plug Power, Inc.	NASDAQ",
"PLBC	Plumas Bancorp	NASDAQ",
"PSTI	Pluristem Therapeutics, Inc.	NASDAQ",
"PLXT	PLX Technology, Inc.	NASDAQ",
"PMCS	PMC - Sierra, Inc.	NASDAQ",
"PMCT	PMC Commercial Trust	NASDAQ",
"PMFG	PMFG, Inc.	NASDAQ",
"PBSK	Poage Bankshares, Inc.	NASDAQ",
"PTSX	Point.360	NASDAQ",
"PNTR	Pointer Telocation Ltd.	NASDAQ",
"PCOM	Points International, Ltd.	NASDAQ",
"PTEK	PokerTek, Inc.	NASDAQ",
"PBCP	Polonia Bancorp, Inc.	NASDAQ",
"PLCM	Polycom, Inc.	NASDAQ",
"POOL	Pool Corporation	NASDAQ",
"POPE	Pope Resources	NASDAQ",
"PLKI	Popeyes Louisiana Kitchen, Inc.	NASDAQ",
"BPOP	Popular, Inc.	NASDAQ",
"BPOPM	Popular, Inc.	NASDAQ",
"BPOPN	Popular, Inc.	NASDAQ",
"PBIB	Porter Bancorp, Inc.	NASDAQ",
"PRAA	Portfolio Recovery Associates, Inc.	NASDAQ",
"PTLA	Portola Pharmaceuticals, Inc.	NASDAQ",
"PSTR	PostRock Energy Corporation	NASDAQ",
"PBPB	Potbelly Corporation	NASDAQ",
"PCH	Potlatch Corporation	NASDAQ",
"POWL	Powell Industries, Inc.	NASDAQ",
"POWI	Power Integrations, Inc.	NASDAQ",
"PSIX	Power Solutions International, Inc.	NASDAQ",
"PRFZ	PowerShares FTSE RAFI US 1500 Small-Mid Portfolio	NASDAQ",
"PAGG	PowerShares Global Agriculture Portfolio	NASDAQ",
"PSAU	PowerShares Global Gold & Precious Metals Portfolio	NASDAQ",
"IPKW	PowerShares International BuyBack Achievers Portfolio	NASDAQ",
"PNQI	PowerShares NASDAQ Internet Portfolio	NASDAQ",
"QQQ	PowerShares QQQ Trust, Series 1	NASDAQ",
"PSCD	PowerShares S&P SmallCap Consumer Discretionary Portfolio	NASDAQ",
"PSCC	PowerShares S&P SmallCap Consumer Staples Portfolio	NASDAQ",
"PSCE	PowerShares S&P SmallCap Energy Portfolio	NASDAQ",
"PSCF	PowerShares S&P SmallCap Financials Portfolio	NASDAQ",
"PSCH	PowerShares S&P SmallCap Health Care Portfolio	NASDAQ",
"PSCI	PowerShares S&P SmallCap Industrials Portfolio	NASDAQ",
"PSCT	PowerShares S&P SmallCap Information Technology Portfolio	NASDAQ",
"PSCM	PowerShares S&P SmallCap Materials Portfolio	NASDAQ",
"PSCU	PowerShares S&P SmallCap Utilities Portfolio	NASDAQ",
"POZN	Pozen, Inc.	NASDAQ",
"PRAN	Prana Biotechnology Ltd	NASDAQ",
"PFBC	Preferred Bank	NASDAQ",
"PLPC	Preformed Line Products Company	NASDAQ",
"PRXI	Premier Exhibitions, Inc.	NASDAQ",
"PFBI	Premier Financial Bancorp, Inc.	NASDAQ",
"PINC	Premier, Inc.	NASDAQ",
"PRGX	PRGX Global, Inc.	NASDAQ",
"PSMT	PriceSmart, Inc.	NASDAQ",
"PBMD	Prima BioMed Ltd	NASDAQ",
"PNRG	PrimeEnergy Corporation	NASDAQ",
"PRMW	Primo Water Corporation	NASDAQ",
"PRIM	Primoris Services Corporation	NASDAQ",
"PVTB	PrivateBancorp, Inc.	NASDAQ",
"PVTBP	PrivateBancorp, Inc.	NASDAQ",
"PKT	Procera Networks, Inc.	NASDAQ",
"PDEX	Pro-Dex, Inc.	NASDAQ",
"IPDN	Professional Diversity Network, Inc.	NASDAQ",
"PFIE	Profire Energy, Inc.	NASDAQ",
"PGNX	Progenics Pharmaceuticals Inc.	NASDAQ",
"PRGS	Progress Software Corporation	NASDAQ",
"PFPT	Proofpoint, Inc.	NASDAQ",
"PRPH	ProPhase Labs, Inc.	NASDAQ",
"RNA	Prosensa Holding N.V.	NASDAQ",
"BIB	ProShares Ultra Nasdaq Biotechnology	NASDAQ",
"TQQQ	ProShares UltraPro QQQ	NASDAQ",
"SQQQ	ProShares UltraPro Short QQQ 	NASDAQ",
"BIS	ProShares UltraShort Nasdaq Biotechnology	NASDAQ",
"PSEC	Prospect Capital Corporation	NASDAQ",
"PGRX	Prospect Global Resources Inc.	NASDAQ",
"PRTA	Prothena Corporation plc	NASDAQ",
"PWX	Providence and Worcester Railroad Company	NASDAQ",
"PROV	Provident Financial Holdings, Inc.	NASDAQ",
"PBIP	Prudential Bancorp, Inc.	NASDAQ",
"PSBH	PSB Holdings, Inc.	NASDAQ",
"PSDV	pSivida Corp.	NASDAQ",
"PMD	Psychemedics Corporation	NASDAQ",
"PTC	PTC Inc.	NASDAQ",
"PTCT	PTC Therapeutics, Inc.	NASDAQ",
"PULB	Pulaski Financial Corp.	NASDAQ",
"PCYO	Pure Cycle Corporation	NASDAQ",
"QADA	QAD Inc.	NASDAQ",
"QADB	QAD Inc.	NASDAQ",
"QCCO	QC Holdings, Inc.	NASDAQ",
"QCRH	QCR Holdings, Inc.	NASDAQ",
"QGEN	Qiagen N.V.	NASDAQ",
"QIWI	QIWI plc	NASDAQ",
"QKLS	QKL Stores, Inc.	NASDAQ",
"QLIK	Qlik Technologies Inc.	NASDAQ",
"QLGC	QLogic Corporation	NASDAQ",
"QLTI	QLT Inc.	NASDAQ",
"QCOM	QUALCOMM Incorporated	NASDAQ",
"QLTY	Quality Distribution, Inc.	NASDAQ",
"QSII	Quality Systems, Inc.	NASDAQ",
"QBAK	Qualstar Corporation	NASDAQ",
"QLYS	Qualys, Inc.	NASDAQ",
"QTWW	Quantum Fuel Systems Technologies Worldwide, Inc.	NASDAQ",
"QTET	Quartet Merger Corp.	NASDAQ",
"QTETR	Quartet Merger Corp.	NASDAQ",
"QTETU	Quartet Merger Corp.	NASDAQ",
"QCOR	Questcor Pharmaceuticals, Inc.	NASDAQ",
"QUIK	QuickLogic Corporation	NASDAQ",
"QDEL	Quidel Corporation	NASDAQ",
"QPAC	Quinpario Acquisiton corp.	NASDAQ",
"QPACU	Quinpario Acquisiton corp.	NASDAQ",
"QPACW	Quinpario Acquisiton corp.	NASDAQ",
"QNST	QuinStreet, Inc.	NASDAQ",
"QUMU	Qumu Corporation	NASDAQ",
"QUNR	Qunar Cayman Islands Limited	NASDAQ",
"DFZ	R.G. Barry Corporation	NASDAQ",
"RRD	R.R. Donnelley & Sons Company	NASDAQ",
"RADA	Rada Electronics Industries Limited	NASDAQ",
"RDCM	Radcom Ltd.	NASDAQ",
"ROIA	Radio One, Inc.	NASDAQ",
"ROIAK	Radio One, Inc.	NASDAQ",
"RSYS	RadiSys Corporation	NASDAQ",
"RDNT	RadNet, Inc.	NASDAQ",
"RDWR	Radware Ltd.	NASDAQ",
"RMBS	Rambus, Inc.	NASDAQ",
"RAND	Rand Capital Corporation	NASDAQ",
"RLOG	Rand Logistics, Inc.	NASDAQ",
"GOLD	Randgold Resources Limited	NASDAQ",
"RPTP	Raptor Pharmaceutical Corp.	NASDAQ",
"RAVN	Raven Industries, Inc.	NASDAQ",
"ROLL	RBC Bearings Incorporated	NASDAQ",
"RCMT	RCM Technologies, Inc.	NASDAQ",
"RDA	RDA Microelectronics, Inc.	NASDAQ",
"RLOC	ReachLocal, Inc.	NASDAQ",
"RDI	Reading International Inc	NASDAQ",
"RDIB	Reading International Inc	NASDAQ",
"RGSE	Real Goods Solar, Inc.	NASDAQ",
"RNWK	RealNetworks, Inc.	NASDAQ",
"RP	RealPage, Inc.	NASDAQ",
"RCPT	Receptos, Inc.	NASDAQ",
"QYLD	Recon Capital NASDAQ-100 Covered Call ETF	NASDAQ",
"RCON	Recon Technology, Ltd.	NASDAQ",
"REPH	Recro Pharma, Inc.	NASDAQ",
"RRGB	Red Robin Gourmet Burgers, Inc.	NASDAQ",
"RDHL	Redhill Biopharma Ltd.	NASDAQ",
"REDF	Rediff.com India Limited	NASDAQ",
"RGDO	Regado BioSciences, Inc.	NASDAQ",
"REGN	Regeneron Pharmaceuticals, Inc.	NASDAQ",
"RGLS	Regulus Therapeutics Inc.	NASDAQ",
"REIS	Reis, Inc	NASDAQ",
"RELV	Reliv&#39; International, Inc.	NASDAQ",
"RLYP	Relypsa, Inc.	NASDAQ",
"MARK	Remark Media, Inc.	NASDAQ",
"REMY	Remy International, Inc.	NASDAQ",
"RNST	Renasant Corporation	NASDAQ",
"REGI	Renewable Energy Group, Inc.	NASDAQ",
"RCII	Rent-A-Center Inc.	NASDAQ",
"RTK	Rentech, Inc.	NASDAQ",
"RENT	Rentrak Corporation	NASDAQ",
"RGEN	Repligen Corporation	NASDAQ",
"RPRX	Repros Therapeutics Inc.	NASDAQ",
"RPRXW	Repros Therapeutics Inc.	NASDAQ",
"RPRXZ	Repros Therapeutics Inc.	NASDAQ",
"RJET	Republic Airways Holdings, Inc.	NASDAQ",
"RBCAA	Republic Bancorp, Inc.	NASDAQ",
"FRBK	Republic First Bancorp, Inc.	NASDAQ",
"REFR	Research Frontiers Incorporated	NASDAQ",
"REXI	Resource America, Inc.	NASDAQ",
"RECN	Resources Connection, Inc.	NASDAQ",
"RGDX	Response Genetics, Inc.	NASDAQ",
"ROIC	Retail Opportunity Investments Corp.	NASDAQ",
"ROICU	Retail Opportunity Investments Corp.	NASDAQ",
"ROICW	Retail Opportunity Investments Corp.	NASDAQ",
"SALE	RetailMeNot, Inc.	NASDAQ",
"RTRX	Retrophin, Inc.	NASDAQ",
"RVNC	Revance Therapeutics, Inc.	NASDAQ",
"RVLT	Revolution Lighting Technologies, Inc.	NASDAQ",
"REXX	Rex Energy Corporation	NASDAQ",
"RFIL	RF Industries, Ltd.	NASDAQ",
"RFMD	RF Micro Devices, Inc.	NASDAQ",
"RGCO	RGC Resources Inc.	NASDAQ",
"RIBT	RiceBran Technologies	NASDAQ",
"RIBTW	RiceBran Technologies	NASDAQ",
"RELL	Richardson Electronics, Ltd.	NASDAQ",
"RICK	Rick&#39;s Cabaret International, Inc.	NASDAQ",
"RIGL	Rigel Pharmaceuticals, Inc.	NASDAQ",
"RNET	RigNet, Inc.	NASDAQ",
"RITT	RIT Technologies Ltd.	NASDAQ",
"RITTW	RIT Technologies Ltd.	NASDAQ",
"RIVR	River Valley Bancorp.	NASDAQ",
"RVBD	Riverbed Technology, Inc.	NASDAQ",
"RVSB	Riverview Bancorp Inc	NASDAQ",
"RLJE	RLJ Entertainment, Inc.	NASDAQ",
"RMGN	RMG Networks Holding Corporation	NASDAQ",
"ROBO	Robo-Stox Global Robotics and Automation Index ETF	NASDAQ",
"FUEL	Rocket Fuel Inc.	NASDAQ",
"RCKB	Rockville Financial, Inc.	NASDAQ",
"RMTI	Rockwell Medical, Inc.	NASDAQ",
"RCKY	Rocky Brands, Inc.	NASDAQ",
"RMCF	Rocky Mountain Chocolate Factory, Inc.	NASDAQ",
"RSTI	Rofin-Sinar Technologies, Inc.	NASDAQ",
"ROIQ	ROI Acquisition Corp. II	NASDAQ",
"ROIQU	ROI Acquisition Corp. II	NASDAQ",
"ROIQW	ROI Acquisition Corp. II	NASDAQ",
"ROSG	Rosetta Genomics Ltd.	NASDAQ",
"ROSE	Rosetta Resources Inc.	NASDAQ",
"ROST	Ross Stores, Inc.	NASDAQ",
"ROVI	Rovi Corporation	NASDAQ",
"RBPAA	Royal Bancshares of Pennsylvania, Inc.	NASDAQ",
"RGLD	Royal Gold, Inc.	NASDAQ",
"ROYL	Royale Energy, Inc.	NASDAQ",
"FUND	Royce Focus Trust, Inc.	NASDAQ",
"RPXC	RPX Corporation	NASDAQ",
"RRST	RRSat Global Communications Network Ltd.	NASDAQ",
"RTIX	RTI Surgical, Inc.	NASDAQ",
"RBCN	Rubicon Technology, Inc.	NASDAQ",
"RUSHA	Rush Enterprises, Inc.	NASDAQ",
"RUSHB	Rush Enterprises, Inc.	NASDAQ",
"RTGN	Ruthigen, Inc.	NASDAQ",
"RUTH	Ruth&#39;s Hospitality Group, Inc.	NASDAQ",
"RXII	RXI Pharmaceuticals Corporation	NASDAQ",
"RYAAY	Ryanair Holdings plc	NASDAQ",
"STBA	S&T Bancorp, Inc.	NASDAQ",
"SANW	S&W Seed Company	NASDAQ",
"SANWZ	S&W Seed Company	NASDAQ",
"SYBT	S.Y. Bancorp, Inc.	NASDAQ",
"SBRA	Sabra Healthcare REIT, Inc.	NASDAQ",
"SBRAP	Sabra Healthcare REIT, Inc.	NASDAQ",
"SAEX	SAExploration Holdings, Inc.	NASDAQ",
"SAFT	Safety Insurance Group, Inc.	NASDAQ",
"SGNT	Sagent Pharmaceuticals, Inc.	NASDAQ",
"SAIA	Saia, Inc.	NASDAQ",
"SALM	Salem Communications Corporation	NASDAQ",
"SAL	Salisbury Bancorp, Inc.	NASDAQ",
"SLXP	Salix Pharmaceuticals, Ltd.	NASDAQ",
"SAFM	Sanderson Farms, Inc.	NASDAQ",
"SNDK	SanDisk Corporation	NASDAQ",
"SASR	Sandy Spring Bancorp, Inc.	NASDAQ",
"SGMO	Sangamo BioSciences, Inc.	NASDAQ",
"SANM	Sanmina Corporation	NASDAQ",
"GCVRZ	Sanofi	NASDAQ",
"SPNS	Sapiens International Corporation N.V.	NASDAQ",
"SAPE	Sapient Corporation	NASDAQ",
"SRPT	Sarepta Therapeutics, Inc.	NASDAQ",
"SBFG	SB Financial Group, Inc.	NASDAQ",
"SBAC	SBA Communications Corporation	NASDAQ",
"SCSC	ScanSource, Inc.	NASDAQ",
"SMIT	Schmitt Industries, Inc.	NASDAQ",
"SCHN	Schnitzer Steel Industries, Inc.	NASDAQ",
"SCHL	Scholastic Corporation	NASDAQ",
"SCLN	SciClone Pharmaceuticals, Inc.	NASDAQ",
"SGMS	Scientific Games Corp	NASDAQ",
"SQI	SciQuest, Inc.	NASDAQ",
"SCYX	SCYNEXIS, Inc.	NASDAQ",
"SEAC	SeaChange International, Inc.	NASDAQ",
"SBCF	Seacoast Banking Corporation of Florida	NASDAQ",
"STX	Seagate Technology.	NASDAQ",
"SHIP	Seanergy Maritime Holdings Corp	NASDAQ",
"SHLD	Sears Holdings Corporation	NASDAQ",
"SHLDV	Sears Holdings Corporation	NASDAQ",
"SHOS	Sears Hometown and Outlet Stores, Inc.	NASDAQ",
"SGEN	Seattle Genetics, Inc.	NASDAQ",
"SNFCA	Security National Financial Corporation	NASDAQ",
"SEIC	SEI Investments Company	NASDAQ",
"SCSS	Select Comfort Corporation	NASDAQ",
"SLTC	Selectica, Inc.	NASDAQ",
"SIGI	Selective Insurance Group, Inc.	NASDAQ",
"LEDS	SemiLEDS Corporation	NASDAQ",
"SMLR	Semler Scientific, Inc.	NASDAQ",
"SMTC	Semtech Corporation	NASDAQ",
"SENEA	Seneca Foods Corp.	NASDAQ",
"SENEB	Seneca Foods Corp.	NASDAQ",
"SNMX	Senomyx, Inc.	NASDAQ",
"SQNM	Sequenom, Inc.	NASDAQ",
"SQBG	Sequential Brands Group, Inc.	NASDAQ",
"SREV	ServiceSource International, Inc.	NASDAQ",
"SEV	Sevcon, Inc.	NASDAQ",
"SVBI	Severn Bancorp Inc	NASDAQ",
"SFXE	SFX Entertainment, Inc.	NASDAQ",
"SGOC	SGOCO Group, Ltd	NASDAQ",
"GAME	Shanda Games Limited	NASDAQ",
"SMED	Sharps Compliance Corp	NASDAQ",
"SHEN	Shenandoah Telecommunications Co	NASDAQ",
"SHLO	Shiloh Industries, Inc.	NASDAQ",
"SHPG	Shire plc	NASDAQ",
"SCVL	Shoe Carnival, Inc.	NASDAQ",
"SHBI	Shore Bancshares Inc	NASDAQ",
"SHOR	ShoreTel, Inc.	NASDAQ",
"SFLY	Shutterfly, Inc.	NASDAQ",
"SIFI	SI Financial Group, Inc.	NASDAQ",
"SIEB	Siebert Financial Corp.	NASDAQ",
"BSRR	Sierra Bancorp	NASDAQ",
"SWIR	Sierra Wireless, Inc.	NASDAQ",
"SIFY	Sify Technologies Limited	NASDAQ",
"SIGA	SIGA Technologies Inc.	NASDAQ",
"SIGM	Sigma Designs, Inc.	NASDAQ",
"SIAL	Sigma-Aldrich Corporation	NASDAQ",
"SGMA	SigmaTron International, Inc.	NASDAQ",
"SBNY	Signature Bank	NASDAQ",
"SBNYW	Signature Bank	NASDAQ",
"SLGN	Silgan Holdings Inc.	NASDAQ",
"SILC	Silicom Ltd	NASDAQ",
"SGI	Silicon Graphics International Corp	NASDAQ",
"SIMG	Silicon Image, Inc.	NASDAQ",
"SLAB	Silicon Laboratories, Inc.	NASDAQ",
"SIMO	Silicon Motion Technology Corporation	NASDAQ",
"SPIL	Siliconware Precision Industries Company, Ltd.	NASDAQ",
"EAGL	Silver Eagle Acquisition Corp.	NASDAQ",
"EAGLU	Silver Eagle Acquisition Corp.	NASDAQ",
"EAGLW	Silver Eagle Acquisition Corp.	NASDAQ",
"SSRI	Silver Standard Resources Inc.	NASDAQ",
"SAMG	Silvercrest Asset Management Group Inc.	NASDAQ",
"SFNC	Simmons First National Corporation	NASDAQ",
"SMPL	Simplicity Bancorp Inc.	NASDAQ",
"SLP	Simulations Plus, Inc.	NASDAQ",
"SINA	Sina Corporation	NASDAQ",
"SBGI	Sinclair Broadcast Group, Inc.	NASDAQ",
"SCOK	SinoCoking Coal and Coke Chemical Industries, Inc	NASDAQ",
"SINO	Sino-Global Shipping America, Ltd.	NASDAQ",
"SVA	Sinovac Biotech, Ltd.	NASDAQ",
"SIRI	Sirius XM Holdings Inc.	NASDAQ",
"SIRO	Sirona Dental Systems, Inc.	NASDAQ",
"SZMK	Sizmek Inc.	NASDAQ",
"SKUL	Skullcandy, Inc.	NASDAQ",
"MOBI	Sky-mobi Limited	NASDAQ",
"SPU	SkyPeople Fruit Juice, Inc.	NASDAQ",
"SKBI	Skystar Bio-Pharmaceutical Company	NASDAQ",
"SKYW	SkyWest, Inc.	NASDAQ",
"SWKS	Skyworks Solutions, Inc.	NASDAQ",
"ISM	SLM Corporation	NASDAQ",
"JSM	SLM Corporation	NASDAQ",
"OSM	SLM Corporation	NASDAQ",
"SLM	SLM Corporation	NASDAQ",
"SLMAP	SLM Corporation	NASDAQ",
"SLMBP	SLM Corporation	NASDAQ",
"SMT	SMART Technologies Inc.	NASDAQ",
"SPRO	SmartPros Ltd.	NASDAQ",
"SWHC	Smith & Wesson Holding Corporation	NASDAQ",
"SMSI	Smith Micro Software, Inc.	NASDAQ",
"SMTX	SMTC Corporation	NASDAQ",
"SMTP	SMTP, Inc.	NASDAQ",
"LNCE	Snyder&#39;s-Lance, Inc.	NASDAQ",
"SODA	SodaStream International Ltd.	NASDAQ",
"SOHU	Sohu.com Inc.	NASDAQ",
"SLRC	Solar Capital Ltd.	NASDAQ",
"SUNS	Solar Senior Capital Ltd.	NASDAQ",
"SCTY	SolarCity Corporation	NASDAQ",
"SZYM	Solazyme, Inc.	NASDAQ",
"SONC	Sonic Corp.	NASDAQ",
"SOFO	Sonic Foundry, Inc.	NASDAQ",
"SONS	Sonus Networks, Inc.	NASDAQ",
"SPHS	Sophiris Bio, Inc.	NASDAQ",
"SORL	SORL Auto Parts, Inc.	NASDAQ",
"SRNE	Sorrento Therapeutics, Inc.	NASDAQ",
"SOHO	Sotherly Hotels Inc.	NASDAQ",
"SOHOL	Sotherly Hotels LP	NASDAQ",
"SFBC	Sound Financial Bancorp, Inc.	NASDAQ",
"SOCB	Southcoast Financial Corporation	NASDAQ",
"SFST	Southern First Bancshares, Inc.	NASDAQ",
"SMBC	Southern Missouri Bancorp, Inc.	NASDAQ",
"SONA	Southern National Bancorp of Virginia, Inc.	NASDAQ",
"SBSI	Southside Bancshares, Inc.	NASDAQ",
"OKSB	Southwest Bancorp, Inc.	NASDAQ",
"SPBC	SP Bancorp, Inc.	NASDAQ",
"SP	SP Plus Corporation	NASDAQ",
"SPAN	Span-America Medical Systems, Inc.	NASDAQ",
"SBSA	Spanish Broadcasting System, Inc.	NASDAQ",
"SGRP	SPAR Group, Inc.	NASDAQ",
"SPAR	Spartan Motors, Inc.	NASDAQ",
"SPTN	Spartan Stores, Inc.	NASDAQ",
"SPPI	Spectrum Pharmaceuticals, Inc.	NASDAQ",
"SPDC	Speed Commerce, Inc.	NASDAQ",
"SPEX	Spherix Incorporated	NASDAQ",
"SAVE	Spirit Airlines, Inc.	NASDAQ",
"SPLK	Splunk Inc.	NASDAQ",
"SPCHA	Sport Chalet, Inc.	NASDAQ",
"SPCHB	Sport Chalet, Inc.	NASDAQ",
"SFM	Sprouts Farmers Market, Inc.	NASDAQ",
"SPSC	SPS Commerce, Inc.	NASDAQ",
"SQBK	Square 1 Financial, Inc.	NASDAQ",
"SSNC	SS&C Technologies Holdings, Inc.	NASDAQ",
"STAA	STAAR Surgical Company	NASDAQ",
"STMP	Stamps.com Inc.	NASDAQ",
"STLY	Stanley Furniture Company, Inc.	NASDAQ",
"SPLS	Staples, Inc.	NASDAQ",
"SBLK	Star Bulk Carriers Corp.	NASDAQ",
"STSI	Star Scientific, Inc.	NASDAQ",
"SBUX	Starbucks Corporation	NASDAQ",
"STRZA	Starz	NASDAQ",
"STRZB	Starz	NASDAQ",
"STFC	State Auto Financial Corporation	NASDAQ",
"STBZ	State Bank Financial Corporation.	NASDAQ",
"SIBC	State Investors Bancorp, Inc.	NASDAQ",
"GASS	StealthGas, Inc.	NASDAQ",
"STLD	Steel Dynamics, Inc.	NASDAQ",
"SMRT	Stein Mart, Inc.	NASDAQ",
"STNR	Steiner Leisure Limited	NASDAQ",
"STEM	StemCells, Inc.	NASDAQ",
"STML	Stemline Therapeutics, Inc.	NASDAQ",
"STXS	Stereotaxis, Inc.	NASDAQ",
"SRCL	Stericycle, Inc.	NASDAQ",
"STRL	Sterling Construction Company Inc	NASDAQ",
"STSA	Sterling Financial Corporation	NASDAQ",
"SHOO	Steven Madden, Ltd.	NASDAQ",
"SSFN	Stewardship Financial Corp	NASDAQ",
"STCK	Stock Building Supply Holdings, Inc.	NASDAQ",
"BANX	StoneCastle Financial Corp	NASDAQ",
"SSYS	Stratasys, Ltd.	NASDAQ",
"STRT	Strattec Security Corporation	NASDAQ",
"STRS	Stratus Properties, Inc.	NASDAQ",
"STRA	Strayer Education, Inc.	NASDAQ",
"STRM	Streamline Health Solutions, Inc.	NASDAQ",
"STB	Student Transportation Inc	NASDAQ",
"SCMP	Sucampo Pharmaceuticals, Inc.	NASDAQ",
"SUBK	Suffolk Bancorp	NASDAQ",
"SUMR	Summer Infant, Inc.	NASDAQ",
"SMMF	Summit Financial Group, Inc.	NASDAQ",
"SSBI	Summit State Bank	NASDAQ",
"SNBC	Sun Bancorp, Inc.	NASDAQ",
"SNHY	Sun Hydraulics Corporation	NASDAQ",
"SNSS	Sunesis Pharmaceuticals, Inc.	NASDAQ",
"GOMO	Sungy Mobile Limited	NASDAQ",
"STKL	SunOpta, Inc.	NASDAQ",
"SPWR	SunPower Corporation	NASDAQ",
"SSH	Sunshine Heart Inc	NASDAQ",
"SMCI	Super Micro Computer, Inc.	NASDAQ",
"SPCB	SuperCom, Ltd.	NASDAQ",
"SCON	Superconductor Technologies Inc.	NASDAQ",
"SGC	Superior Uniform Group, Inc.	NASDAQ",
"SUPN	Supernus Pharmaceuticals, Inc.	NASDAQ",
"SPPR	Supertel Hospitality, Inc.	NASDAQ",
"SPPRO	Supertel Hospitality, Inc.	NASDAQ",
"SPPRP	Supertel Hospitality, Inc.	NASDAQ",
"SPRT	support.com, Inc.	NASDAQ",
"SCAI	Surgical Care Affiliates, Inc.	NASDAQ",
"SRDX	SurModics, Inc.	NASDAQ",
"SUSQ	Susquehanna Bancshares, Inc.	NASDAQ",
"SBBX	Sussex Bancorp	NASDAQ",
"SUTR	Sutor Technology Group Limited	NASDAQ",
"STRN	Sutron Corporation	NASDAQ",
"SIVB	SVB Financial Group	NASDAQ",
"SIVBO	SVB Financial Group	NASDAQ",
"SWSH	Swisher Hygiene, Inc.	NASDAQ",
"SYKE	Sykes Enterprises, Incorporated	NASDAQ",
"SYMC	Symantec Corporation	NASDAQ",
"SYNC	Synacor, Inc.	NASDAQ",
"GEVA	Synageva BioPharma Corp.	NASDAQ",
"SYNL	Synalloy Corporation	NASDAQ",
"SYNA	Synaptics Incorporated	NASDAQ",
"SNCR	Synchronoss Technologies, Inc.	NASDAQ",
"SURG	Synergetics USA, Inc.	NASDAQ",
"SGYP	Synergy Pharmaceuticals, Inc.	NASDAQ",
"SGYPU	Synergy Pharmaceuticals, Inc.	NASDAQ",
"SGYPW	Synergy Pharmaceuticals, Inc.	NASDAQ",
"ELOS	Syneron Medical Ltd.	NASDAQ",
"SNPS	Synopsys, Inc.	NASDAQ",
"SNTA	Synta Pharmaceuticals Corp.	NASDAQ",
"SYNT	Syntel, Inc.	NASDAQ",
"SYMX	Synthesis Energy Systems, Inc.	NASDAQ",
"SYNM	Syntroleum Corporation	NASDAQ",
"SYUT	Synutra International, Inc.	NASDAQ",
"SYPR	Sypris Solutions, Inc.	NASDAQ",
"TROW	T. Rowe Price Group, Inc.	NASDAQ",
"TAIT	Taitron Components Incorporated	NASDAQ",
"TTWO	Take-Two Interactive Software, Inc.	NASDAQ",
"TLMR	Talmer Bancorp, Inc.	NASDAQ",
"TNDM	Tandem Diabetes Care, Inc.	NASDAQ",
"TLF	Tandy Leather Factory, Inc.	NASDAQ",
"TNGO	Tangoe, Inc.	NASDAQ",
"TEDU	Tarena International, Inc.	NASDAQ",
"TRGT	Targacept, Inc.	NASDAQ",
"TASR	TASER International, Inc.	NASDAQ",
"TATT	TAT Technologies Ltd.	NASDAQ",
"TAYC	Taylor Capital Group, Inc.	NASDAQ",
"TAYCO	Taylor Capital Group, Inc.	NASDAQ",
"TAYCP	Taylor Capital Group, Inc.	NASDAQ",
"TAYD	Taylor Devices, Inc.	NASDAQ",
"TCPC	TCP Capital Corp.	NASDAQ",
"TEAR	TearLab Corporation	NASDAQ",
"TECD	Tech Data Corporation	NASDAQ",
"TECH	Techne Corporation	NASDAQ",
"TCCO	Technical Communications Corporation	NASDAQ",
"TTGT	TechTarget, Inc.	NASDAQ",
"TGLS	Tecnoglass Inc.	NASDAQ",
"TECUA	Tecumseh Products Company	NASDAQ",
"TECUB	Tecumseh Products Company	NASDAQ",
"TKMR	Tekmira Pharmaceuticals Corp	NASDAQ",
"TSYS	TeleCommunication Systems, Inc.	NASDAQ",
"TNAV	TeleNav, Inc.	NASDAQ",
"TTEC	TeleTech Holdings, Inc.	NASDAQ",
"TELK	Telik, Inc.	NASDAQ",
"TBNK	Territorial Bancorp Inc.	NASDAQ",
"TSRO	TESARO, Inc.	NASDAQ",
"TESO	Tesco Corporation	NASDAQ",
"TSLA	Tesla Motors, Inc.	NASDAQ",
"TESS	TESSCO Technologies Incorporated	NASDAQ",
"TSRA	Tessera Technologies, Inc.	NASDAQ",
"TTEK	Tetra Tech, Inc.	NASDAQ",
"TLOG	TetraLogic Pharmaceuticals Corporation	NASDAQ",
"TTPH	Tetraphase Pharmaceuticals, Inc.	NASDAQ",
"TCBI	Texas Capital Bancshares, Inc.	NASDAQ",
"TCBIL	Texas Capital Bancshares, Inc.	NASDAQ",
"TCBIP	Texas Capital Bancshares, Inc.	NASDAQ",
"TCBIW	Texas Capital Bancshares, Inc.	NASDAQ",
"TXN	Texas Instruments Incorporated	NASDAQ",
"TXRH	Texas Roadhouse, Inc.	NASDAQ",
"THRD	TF Financial Corporation	NASDAQ",
"TFSL	TFS Financial Corporation	NASDAQ",
"TGTX	TG Therapeutics, Inc.	NASDAQ",
"TGE	TGC Industries, Inc.	NASDAQ",
"ABCO	The Advisory Board Company	NASDAQ",
"ANDE	The Andersons, Inc.	NASDAQ",
"TBBK	The Bancorp, Inc.	NASDAQ",
"BKYF	The Bank of Kentucky Financial Corp.	NASDAQ",
"BONT	The Bon-Ton Stores, Inc.	NASDAQ",
"CG	The Carlyle Group L.P.	NASDAQ",
"CAKE	The Cheesecake Factory Incorporated	NASDAQ",
"CHEF	The Chefs&#39; Warehouse, Inc.	NASDAQ",
"PLCE	The Children&#39;s Place Retail Stores, Inc.	NASDAQ",
"TCFC	The Community Financial Corporation	NASDAQ",
"DSGX	The Descartes Systems Group Inc.	NASDAQ",
"DXYN	The Dixie Group, Inc.	NASDAQ",
"ENSG	The Ensign Group, Inc.	NASDAQ",
"XONE	The ExOne Company	NASDAQ",
"FINL	The Finish Line, Inc.	NASDAQ",
"FBMS	The First Bancshares, Inc.	NASDAQ",
"FLIC	The First of Long Island Corporation	NASDAQ",
"TFM	The Fresh Market, Inc.	NASDAQ",
"GT	The Goodyear Tire & Rubber Company	NASDAQ",
"HCKT	The Hackett Group, Inc.	NASDAQ",
"HAIN	The Hain Celestial Group, Inc.	NASDAQ",
"CUBA	The Herzfeld Caribbean Basin Fund, Inc.	NASDAQ",
"INTG	The Intergroup Corporation	NASDAQ",
"KEYW	The KEYW Holding Corporation	NASDAQ",
"MSG	The Madison Square Garden Company	NASDAQ",
"TMNG	The Management Network Group, Inc.	NASDAQ",
"MDCO	The Medicines Company	NASDAQ",
"MIDD	The Middleby Corporation	NASDAQ",
"NDAQ	The NASDAQ OMX Group, Inc.	NASDAQ",
"NAVG	The Navigators Group, Inc.	NASDAQ",
"PTRY	The Pantry, Inc.	NASDAQ",
"PCLN	The Priceline Group Inc. 	NASDAQ",
"PRSC	The Providence Service Corporation	NASDAQ",
"SPNC	The Spectranetics Corporation	NASDAQ",
"ULTI	The Ultimate Software Group, Inc.	NASDAQ",
"WTSL	The Wet Seal, Inc.	NASDAQ",
"YORW	The York Water Company	NASDAQ",
"NCTY	The9 Limited	NASDAQ",
"THRX	Theravance, Inc.	NASDAQ",
"TST	TheStreet, Inc.	NASDAQ",
"TCRD	THL Credit, Inc.	NASDAQ",
"THOR	Thoratec Corporation	NASDAQ",
"THLD	Threshold Pharmaceuticals, Inc.	NASDAQ",
"THTI	THT Heat Transfer Technology, Inc.	NASDAQ",
"OINK	Tianli Agritech, Inc.	NASDAQ",
"TIBX	TIBCO Software, Inc.	NASDAQ",
"TICC	TICC Capital Corp.	NASDAQ",
"TIGR	TigerLogic Corporation	NASDAQ",
"TTS	Tile Shop Hldgs, Inc.	NASDAQ",
"TSBK	Timberland Bancorp, Inc.	NASDAQ",
"TIPT	Tiptree Financial Inc.	NASDAQ",
"TITN	Titan Machinery Inc.	NASDAQ",
"TIVO	TiVo Inc.	NASDAQ",
"TNXP	Tonix Pharmaceuticals Holding Corp.	NASDAQ",
"TISA	Top Image Systems, Ltd.	NASDAQ",
"TOPS	TOP Ships Inc.	NASDAQ",
"TORM          	TOR Minerals International Inc	NASDAQ",
"TRCH	Torchlight Energy Resources, Inc.	NASDAQ",
"TRNX	Tornier N.V.	NASDAQ",
"TOFC	Tower Financial Corporation	NASDAQ",
"TWGP	Tower Group International, Ltd.	NASDAQ",
"TSEM	Tower Semiconductor Ltd.	NASDAQ",
"TWER	Towerstream Corporation	NASDAQ",
"CLUB	Town Sports International Holdings, Inc.	NASDAQ",
"TOWN	Towne Bank	NASDAQ",
"TSCO	Tractor Supply Company	NASDAQ",
"TSRE	Trade Street Residential, Inc.	NASDAQ",
"TWMC	Trans World Entertainment Corp.	NASDAQ",
"TACT	TransAct Technologies Incorporated	NASDAQ",
"TRNS	Transcat, Inc.	NASDAQ",
"TSPT	Transcept Pharmaceuticals, Inc.	NASDAQ",
"TGA	Transglobe Energy Corp	NASDAQ",
"TTHI	Transition Therapeutics, Inc.	NASDAQ",
"TZOO	Travelzoo Inc.	NASDAQ",
"TREE	Tree.com, Inc.	NASDAQ",
"TRVN	Trevena, Inc.	NASDAQ",
"TCBK	TriCo Bancshares	NASDAQ",
"TRS	TriMas Corporation	NASDAQ",
"TRMB	Trimble Navigation Limited	NASDAQ",
"TRIB	Trinity Biotech plc	NASDAQ",
"TRIP	TripAdvisor, Inc.	NASDAQ",
"TQNT	TriQuint Semiconductor, Inc.	NASDAQ",
"TSC	TriState Capital Holdings, Inc.	NASDAQ",
"TRIT	Tri-Tech Holding Inc.	NASDAQ",
"TROV	TrovaGene, Inc.	NASDAQ",
"TROVU	TrovaGene, Inc.	NASDAQ",
"TROVW	TrovaGene, Inc.	NASDAQ",
"THST	Truett-Hurst, Inc.	NASDAQ",
"TBOW	Trunkbow International Holdings Ltd.	NASDAQ",
"TRST	TrustCo Bank Corp NY	NASDAQ",
"TRMK	Trustmark Corporation	NASDAQ",
"TSRI	TSR, Inc.	NASDAQ",
"TTMI	TTM Technologies, Inc.	NASDAQ",
"TCX	Tucows Inc.	NASDAQ",
"TUES	Tuesday Morning Corp.	NASDAQ",
"TWTC	tw telecom inc.	NASDAQ",
"FOX	Twenty-First Century Fox, Inc.	NASDAQ",
"FOXA	Twenty-First Century Fox, Inc.	NASDAQ",
"TWIN	Twin Disc, Incorporated	NASDAQ",
"TRCB	Two River Bancorp	NASDAQ",
"USCR	U S Concrete, Inc.	NASDAQ",
"PRTS	U.S. Auto Parts Network, Inc.	NASDAQ",
"USEG	U.S. Energy Corp.	NASDAQ",
"GROW	U.S. Global Investors, Inc.	NASDAQ",
"UBIC	UBIC, Inc.	NASDAQ",
"UBNT	Ubiquiti Networks, Inc.	NASDAQ",
"UFPT	UFP Technologies, Inc.	NASDAQ",
"ULTA	Ulta Salon, Cosmetics & Fragrance, Inc.	NASDAQ",
"UCTT	Ultra Clean Holdings, Inc.	NASDAQ",
"RARE	Ultragenyx Pharmaceutical Inc.	NASDAQ",
"ULBI	Ultralife Corporation	NASDAQ",
"ULTR	Ultrapetrol (Bahamas) Limited	NASDAQ",
"UTEK	Ultratech, Inc.	NASDAQ",
"UMBF	UMB Financial Corporation	NASDAQ",
"UMPQ	Umpqua Holdings Corporation	NASDAQ",
"UNAM	Unico American Corporation	NASDAQ",
"UNIS	Unilife Corporation	NASDAQ",
"UNB	Union Bankshares, Inc.	NASDAQ",
"UBSH	Union First Market Bankshares Corporation	NASDAQ",
"UNXL	Uni-Pixel, Inc.	NASDAQ",
"QURE	uniQure N.V.	NASDAQ",
"UBCP	United Bancorp, Inc.	NASDAQ",
"UBOH	United Bancshares, Inc.	NASDAQ",
"UBSI	United Bankshares, Inc.	NASDAQ",
"UCBA	United Community Bancorp	NASDAQ",
"UCBI	United Community Banks, Inc.	NASDAQ",
"UCFC	United Community Financial Corp.	NASDAQ",
"UBNK	United Financial Bancorp, Inc.	NASDAQ",
"UFCS	United Fire Group, Inc	NASDAQ",
"UIHC	United Insurance Holdings Corp.	NASDAQ",
"UNFI	United Natural Foods, Inc.	NASDAQ",
"UNTD	United Online, Inc.	NASDAQ",
"UBFO	United Security Bancshares	NASDAQ",
"USBI	United Security Bancshares, Inc.	NASDAQ",
"USLM	United States Lime & Minerals, Inc.	NASDAQ",
"USTR	United Stationers Inc.	NASDAQ",
"UTHR	United Therapeutics Corporation	NASDAQ",
"UG	United-Guardian, Inc.	NASDAQ",
"UNTK	UniTek Global Services, Inc.	NASDAQ",
"UNTY	Unity Bancorp, Inc.	NASDAQ",
"OLED	Universal Display Corporation	NASDAQ",
"UEIC	Universal Electronics Inc.	NASDAQ",
"UFPI	Universal Forest Products, Inc.	NASDAQ",
"USAP	Universal Stainless & Alloy Products, Inc.	NASDAQ",
"UACL	Universal Truckload Services, Inc.	NASDAQ",
"UVSP	Univest Corporation of Pennsylvania	NASDAQ",
"UPIP	Unwired Planet, Inc.	NASDAQ",
"URRE	Uranium Resources, Inc.	NASDAQ",
"URBN	Urban Outfitters, Inc.	NASDAQ",
"UPI	Uroplasty, Inc.	NASDAQ",
"ECOL	US Ecology, Inc.	NASDAQ",
"USMO	USA Mobility, Inc.	NASDAQ",
"USAT	USA Technologies, Inc.	NASDAQ",
"USATP	USA Technologies, Inc.	NASDAQ",
"USAK	USA Truck, Inc.	NASDAQ",
"USMD	USMD Holdings, Inc.	NASDAQ",
"UTMD	Utah Medical Products, Inc.	NASDAQ",
"UTIW	UTi Worldwide Inc.	NASDAQ",
"UTSI	UTStarcom Holdings Corp	NASDAQ",
"VYFC	Valley Financial Corporation	NASDAQ",
"VLYWW	Valley National Bancorp	NASDAQ",
"VALU	Value Line, Inc.	NASDAQ",
"VVTV	ValueVision Media, Inc.	NASDAQ",
"VNDA	Vanda Pharmaceuticals Inc.	NASDAQ",
"VWOB	Vanguard Emerging Markets Government Bond ETF	NASDAQ",
"VNQI	Vanguard Global ex-U.S. Real Estate ETF	NASDAQ",
"VGIT	Vanguard Intermediate -Term Government Bond ETF	NASDAQ",
"VCIT	Vanguard Intermediate-Term Corporate Bond ETF	NASDAQ",
"VCLT	Vanguard Long-Term Corporate Bond ETF	NASDAQ",
"VGLT	Vanguard Long-Term Government Bond ETF	NASDAQ",
"VMBS	Vanguard Mortgage-Backed Securities ETF	NASDAQ",
"VNR	Vanguard Natural Resources LLC	NASDAQ",
"VNRAP	Vanguard Natural Resources LLC	NASDAQ",
"VNRBP	Vanguard Natural Resources LLC	NASDAQ",
"VONE	Vanguard Russell 1000 ETF	NASDAQ",
"VONG	Vanguard Russell 1000 Growth ETF	NASDAQ",
"VONV	Vanguard Russell 1000 Value ETF	NASDAQ",
"VTWO	Vanguard Russell 2000 ETF	NASDAQ",
"VTWG	Vanguard Russell 2000 Growth ETF	NASDAQ",
"VTWV	Vanguard Russell 2000 Value ETF	NASDAQ",
"VTHR	Vanguard Russell 3000 ETF	NASDAQ",
"VCSH	Vanguard Short-Term Corporate Bond ETF	NASDAQ",
"VGSH	Vanguard Short-Term Government ETF	NASDAQ",
"VTIP	Vanguard Short-Term Inflation-Protected Securities Index Fund	NASDAQ",
"BNDX	Vanguard Total International Bond ETF	NASDAQ",
"VXUS	Vanguard Total International Stock ETF	NASDAQ",
"VRNS	Varonis Systems, Inc.	NASDAQ",
"VDSI	VASCO Data Security International, Inc.	NASDAQ",
"VASC	Vascular Solutions, Inc.	NASDAQ",
"WOOF	VCA Antech, Inc.	NASDAQ",
"VECO	Veeco Instruments Inc.	NASDAQ",
"TVIZ	VelocityShares Daily 2x VIX Medium Term ETN	NASDAQ",
"ASDR	VelocityShares Emerging Asia DR ETF	NASDAQ",
"EMDR	VelocityShares Emerging Markets DR ETF	NASDAQ",
"ERW	VelocityShares Equal Risk Weighted Large Cap ETF	NASDAQ",
"RUDR	VelocityShares Russia Select DR ETF	NASDAQ",
"APPY	Venaxis, Inc.	NASDAQ",
"VTUS	Ventrus Biosciences, Inc.	NASDAQ",
"VRA	Vera Bradley, Inc.	NASDAQ",
"VCYT	Veracyte, Inc.	NASDAQ",
"VSTM	Verastem, Inc.	NASDAQ",
"VRNT	Verint Systems Inc.	NASDAQ",
"VRSN	VeriSign, Inc.	NASDAQ",
"VRSK	Verisk Analytics, Inc.	NASDAQ",
"VRML	Vermillion, Inc.	NASDAQ",
"VSAR	Versartis, Inc.	NASDAQ",
"VTNR	Vertex Energy, Inc	NASDAQ",
"VRTX	Vertex Pharmaceuticals Incorporated	NASDAQ",
"VRTA	Vestin Realty Mortgage I, Inc.	NASDAQ",
"VRTB	Vestin Realty Mortgage II, Inc.	NASDAQ",
"VIA	Viacom Inc.	NASDAQ",
"VIAB	Viacom Inc.	NASDAQ",
"VSAT	ViaSat, Inc.	NASDAQ",
"VIAS	Viasystems Group, Inc.	NASDAQ",
"VICL	Vical Incorporated	NASDAQ",
"VICR	Vicor Corporation	NASDAQ",
"VUSE	Vident Core US Equity ETF	NASDAQ",
"VIDI	Vident International Equity Fund	NASDAQ",
"VIDE	Video Display Corporation	NASDAQ",
"VPFG	ViewPoint Financial Group, Inc.	NASDAQ",
"VIEW	Viewtran Group, Inc.	NASDAQ",
"VBFC	Village Bank and Trust Financial Corp.	NASDAQ",
"VLGEA	Village Super Market, Inc.	NASDAQ",
"VIMC	Vimicro International Corporation	NASDAQ",
"VIP	VimpelCom Ltd.	NASDAQ",
"VIRC	Virco Manufacturing Corporation	NASDAQ",
"VSCP	VirtualScopics, Inc.	NASDAQ",
"VRTS	Virtus Investment Partners, Inc.	NASDAQ",
"VRTU	Virtusa Corporation	NASDAQ",
"VISN	VisionChina Media, Inc.	NASDAQ",
"VSCI	Vision-Sciences, Inc.	NASDAQ",
"VPRT	Vistaprint N.V.	NASDAQ",
"VITC	Vitacost.com, Inc.	NASDAQ",
"VTSS	Vitesse Semiconductor Corporation	NASDAQ",
"VVUS	VIVUS, Inc.	NASDAQ",
"VOCS	Vocus, Inc.	NASDAQ",
"VOD	Vodafone Group Plc	NASDAQ",
"VOLC	Volcano Corporation	NASDAQ",
"VLTC	Voltari Corporation	NASDAQ",
"VOXX	VOXX International Corporation	NASDAQ",
"VRNG	Vringo, Inc.	NASDAQ",
"VRNGW	Vringo, Inc.	NASDAQ",
"VSEC	VSE Corporation	NASDAQ",
"WRES	Warren Resources, Inc.	NASDAQ",
"WBCO	Washington Banking Company	NASDAQ",
"WAFD	Washington Federal, Inc.	NASDAQ",
"WAFDW	Washington Federal, Inc.	NASDAQ",
"WASH	Washington Trust Bancorp, Inc.	NASDAQ",
"WFBI	WashingtonFirst Bankshares Inc	NASDAQ",
"WSBF	Waterstone Financial, Inc.	NASDAQ",
"WAVX	Wave Systems Corp.	NASDAQ",
"WAYN	Wayne Savings Bancshares Inc.	NASDAQ",
"WSTG	Wayside Technology Group, Inc.	NASDAQ",
"WDFC	WD-40 Company	NASDAQ",
"WWWW	Web.com Group, Inc.	NASDAQ",
"WBMD	WebMD Health Corp	NASDAQ",
"WEBK	Wellesley Bancorp, Inc.	NASDAQ",
"WEN	Wendy&#39;s Company (The)	NASDAQ",
"WERN	Werner Enterprises, Inc.	NASDAQ",
"WSBC	WesBanco, Inc.	NASDAQ",
"WTBA	West Bancorporation	NASDAQ",
"WSTC	West Corporation	NASDAQ",
"WMAR	West Marine, Inc.	NASDAQ",
"WABC	Westamerica Bancorporation	NASDAQ",
"WBB	Westbury Bancorp, Inc.	NASDAQ",
"WSTL	Westell Technologies, Inc.	NASDAQ",
"WDC	Western Digital Corporation	NASDAQ",
"WFD	Westfield Financial, Inc.	NASDAQ",
"WLB	Westmoreland Coal Company	NASDAQ",
"WLBPZ	Westmoreland Coal Company	NASDAQ",
"WPRT	Westport Innovations Inc	NASDAQ",
"WEYS	Weyco Group, Inc.	NASDAQ",
"WHLR	Wheeler Real Estate Investment Trust, Inc.	NASDAQ",
"WHF	WhiteHorse Finance, Inc.	NASDAQ",
"WHFBL	WhiteHorse Finance, Inc.	NASDAQ",
"WFM	Whole Foods Market, Inc.	NASDAQ",
"WILN	Wi-Lan Inc	NASDAQ",
"WVVI	Willamette Valley Vineyards, Inc.	NASDAQ",
"WLDN	Willdan Group, Inc.	NASDAQ",
"WLFC	Willis Lease Finance Corporation	NASDAQ",
"WIBC	Wilshire Bancorp, Inc.	NASDAQ",
"WIN	Windstream Holdings, Inc.	NASDAQ",
"WINA	Winmark Corporation	NASDAQ",
"WTFC	Wintrust Financial Corporation	NASDAQ",
"WTFCW	Wintrust Financial Corporation	NASDAQ",
"AGND	WisdomTree Barclays U.S. Aggregate Bond Negative Duration Fund	NASDAQ",
"AGZD	WisdomTree Barclays U.S. Aggregate Bond Zero Duration Fund	NASDAQ",
"HYND	WisdomTree BofA Merrill Lynch High Yield Bond Negative Duratio	NASDAQ",
"HYZD	WisdomTree BofA Merrill Lynch High Yield Bond Zero Duration Fu	NASDAQ",
"CHXF	WisdomTree China Dividend Ex-Financials Fund	NASDAQ",
"EMCG	WisdomTree Emerging Markets Consumer Growth Fund	NASDAQ",
"EMCB	WisdomTree Emerging Markets Corporate Bond Fund	NASDAQ",
"DGRE	WisdomTree Emerging Markets Dividend Growth Fund	NASDAQ",
"DXGE	WisdomTree Germany Hedged Equity Fund	NASDAQ",
"GLCB	WisdomTree Global Corporate Bond Fund	NASDAQ",
"WETF	WisdomTree Investments, Inc.	NASDAQ",
"DXJS	WisdomTree Japan Hedged SmallCap Equity Fund	NASDAQ",
"JGBB	WisdomTree Japan Interest Rate Strategy Fund	NASDAQ",
"DXKW	WisdomTree Korea Hedged Equity Fund	NASDAQ",
"GULF	WisdomTree Middle East Dividend Fund	NASDAQ",
"DGRW	WisdomTree U.S. Dividend Growth Fund	NASDAQ",
"DGRS	WisdomTree U.S. SmallCap Dividend Growth Fund	NASDAQ",
"DXPS	WisdomTree United Kingdom Hedged Equity Fund	NASDAQ",
"WIX	Wix.com Ltd.	NASDAQ",
"WBKC	Wolverine Bancorp, Inc.	NASDAQ",
"WWD	Woodward, Inc.	NASDAQ",
"WRLD	World Acceptance Corporation	NASDAQ",
"XWES	World Energy Solutions Inc (DE)	NASDAQ",
"WPCS	WPCS International Incorporated	NASDAQ",
"WPPGY	WPP plc	NASDAQ",
"WMGI	Wright Medical Group, Inc.	NASDAQ",
"WMGIZ	Wright Medical Group, Inc.	NASDAQ",
"WSFS	WSFS Financial Corporation	NASDAQ",
"WSFSL	WSFS Financial Corporation	NASDAQ",
"WSCI	WSI Industries Inc.	NASDAQ",
"WVFC	WVS Financial Corp.	NASDAQ",
"WYNN	Wynn Resorts, Limited	NASDAQ",
"XNCR	Xencor, Inc.	NASDAQ",
"XBKS	Xenith Bankshares, Inc.	NASDAQ",
"XNPT	XenoPort, Inc.	NASDAQ",
"XGTI	XG Technology, Inc	NASDAQ",
"XGTIW	XG Technology, Inc	NASDAQ",
"XLNX	Xilinx, Inc.	NASDAQ",
"XOMA	XOMA Corporation	NASDAQ",
"XOOM	Xoom Corporation	NASDAQ",
"XPLR	Xplore Technologies Corp	NASDAQ",
"XRSC	XRS Corporation	NASDAQ",
"XTLB	XTL Biopharmaceuticals Ltd.	NASDAQ",
"YDKN	Yadkin Financial Corporation	NASDAQ",
"YHOO	Yahoo! Inc.	NASDAQ",
"YNDX	Yandex N.V.	NASDAQ",
"YONG	Yongye International, Inc.	NASDAQ",
"YOD	You On Demand Holdings, Inc.	NASDAQ",
"YRCW	YRC Worldwide, Inc.	NASDAQ",
"YY	YY Inc.	NASDAQ",
"ZAGG	ZAGG Inc	NASDAQ",
"ZLCS	Zalicus Inc.	NASDAQ",
"ZAZA	ZaZa Energy Corporation	NASDAQ",
"ZBRA	Zebra Technologies Corporation	NASDAQ",
"ZLTQ	ZELTIQ Aesthetics, Inc.	NASDAQ",
"ZHNE	Zhone Technologies, Inc.	NASDAQ",
"Z	Zillow, Inc.	NASDAQ",
"ZN	Zion Oil & Gas Inc	NASDAQ",
"ZION	Zions Bancorporation	NASDAQ",
"ZIONW	Zions Bancorporation	NASDAQ",
"ZIONZ	Zions Bancorporation	NASDAQ",
"ZIOP	ZIOPHARM Oncology Inc	NASDAQ",
"ZIPR	ZipRealty, Inc.	NASDAQ",
"ZIXI	Zix Corporation	NASDAQ",
"ZGNX	Zogenix, Inc.	NASDAQ",
"ZOOM	Zoom Technologies, Inc.	NASDAQ",
"ZU	zulily, inc.	NASDAQ",
"ZUMZ	Zumiez Inc.	NASDAQ",
"ZIGO	Zygo Corporation	NASDAQ",
"ZNGA	Zynga Inc.	NASDAQ",
